"state","date_updated","new_cases","tot_cases","Administered","Series_Complete_Yes","Additional_Doses"
AK,"12/17/2020",3417,41855,2,0,""
AK,"12/24/2020",2223,44078,8578,0,""
AK,"12/31/2020",1724,45802,14550,0,""
AK,"01/07/2021",2026,47828,21830,0,""
AK,"01/14/2021",1973,49801,42596,0,""
AK,"01/21/2021",1377,51178,71907,0,""
AK,"01/28/2021",1181,52359,105858,0,""
AK,"02/04/2021",946,53305,129936,0,""
AK,"02/11/2021",989,54294,162273,0,""
AK,"02/18/2021",807,55101,199151,0,""
AK,"02/25/2021",885,55986,249559,0,""
AK,"03/04/2021",876,56862,276891,0,""
AK,"03/11/2021",910,57772,313365,122197,""
AK,"03/18/2021",914,58686,351093,138464,""
AK,"03/25/2021",944,59630,384503,150980,""
AK,"04/01/2021",1186,60816,411529,165325,""
AK,"04/08/2021",1208,62024,443287,186597,""
AK,"04/15/2021",1113,63137,499815,225221,""
AK,"04/22/2021",1146,64283,530134,242474,""
AK,"04/29/2021",1042,65325,550524,255008,""
AK,"05/06/2021",731,66056,567031,265869,""
AK,"05/13/2021",565,66621,578970,273310,""
AK,"05/20/2021",453,67074,593159,279464,""
AK,"05/27/2021",297,67371,605559,284731,""
AK,"06/03/2021",230,67601,614726,289158,""
AK,"06/10/2021",185,67786,625893,296184,""
AK,"06/17/2021",155,67941,636187,302820,""
AK,"06/24/2021",237,68178,643516,307246,""
AK,"07/01/2021",257,68435,660235,314489,""
AK,"07/08/2021",313,68748,679337,323717,""
AK,"07/15/2021",572,69320,685764,327289,""
AK,"07/22/2021",1199,70519,689556,329981,""
AK,"07/29/2021",1546,72065,695163,332136,""
AK,"08/05/2021",1892,73957,701729,334716,""
AK,"08/12/2021",2112,76069,706538,336622,""
AK,"08/19/2021",3001,79070,714088,339825,""
AK,"08/26/2021",3357,82427,723342,343274,0
AK,"09/02/2021",3651,86078,733429,346399,0
AK,"09/09/2021",4264,90342,749630,351799,0
AK,"09/16/2021",4887,95229,761075,355707,0
AK,"09/23/2021",6258,101487,775149,363764,0
AK,"09/30/2021",8436,109923,792368,370114,0
AK,"10/07/2021",5744,115667,807903,373411,0
AK,"10/14/2021",6177,121844,820703,376113,0
AK,"10/21/2021",5530,127374,847207,380783,37109
AK,"10/28/2021",4625,131999,863531,384105,47708
AK,"11/04/2021",4134,136133,879619,386038,59695
AK,"11/11/2021",3391,139524,906157,389235,78209
AK,"11/18/2021",2919,142443,930894,393233,89557
AK,"11/25/2021",2349,144792,946031,395164,98481
AK,"12/02/2021",1716,146508,963790,398122,107907
AK,"12/09/2021",1510,148018,985628,404199,119007
AK,"12/16/2021",1219,149237,1001669,407929,128271
AK,"12/23/2021",1046,150283,1015137,410287,136704
AK,"12/30/2021",2080,152363,1024695,412110,142456
AK,"01/06/2022",5523,157886,1033747,413827,147814
AK,"01/13/2022",12166,170052,1045775,416173,155021
AK,"01/20/2022",15735,185787,1055678,424625,160973
AK,"01/27/2022",16839,202626,1064346,426170,166328
AK,"02/03/2022",13422,216048,1065664,436875,174850
AK,"02/10/2022",8117,224165,1069743,437871,176958
AK,"02/17/2022",3958,228123,1089446,444386,180070
AK,"02/24/2022",2684,230807,1093808,445530,181923
AK,"03/03/2022",2091,232898,1096842,446380,183296
AK,"03/10/2022",2440,235338,1106099,448898,187318
AK,"03/17/2022",1407,236745,1108082,449380,188128
AK,"03/24/2022",1423,238168,1112545,450551,189845
AK,"03/31/2022",1445,239613,1115657,451313,191069
AK,"04/07/2022",1377,240990,1124251,452443,192845
AK,"04/14/2022",1237,242227,1130226,453043,193865
AK,"04/21/2022",1513,243740,1137994,454876,195254
AK,"04/28/2022",1425,245165,1143255,455411,196302
AK,"05/05/2022",1417,246582,1148357,456039,197303
AK,"05/12/2022",1539,248121,1152507,457317,199905
AK,"05/19/2022",1697,249818,1156712,457873,200659
AK,"05/26/2022",1881,251699,1161182,458442,201687
AK,"06/02/2022",1944,253643,1165055,459024,202603
AK,"06/09/2022",2057,255700,1168522,459509,203591
AK,"06/16/2022",1982,257682,1171773,459810,204412
AL,"12/17/2020",25453,305640,193,0,""
AL,"12/24/2020",28929,334569,15857,0,""
AL,"12/31/2020",22251,356820,26711,0,""
AL,"01/07/2021",27365,384185,48888,0,""
AL,"01/14/2021",26811,410996,92300,0,""
AL,"01/21/2021",18659,429655,165919,0,""
AL,"01/28/2021",19432,449087,278993,0,""
AL,"02/04/2021",15974,465061,408428,0,""
AL,"02/11/2021",10954,476015,543237,0,""
AL,"02/18/2021",7162,483177,672038,0,""
AL,"02/25/2021",6988,490165,864757,0,""
AL,"03/04/2021",6979,497144,1032171,0,""
AL,"03/11/2021",4256,501400,1209802,452746,""
AL,"03/18/2021",8065,509465,1390066,533375,""
AL,"03/25/2021",3204,512669,1579091,600666,""
AL,"04/01/2021",2684,515353,1771979,673773,""
AL,"04/08/2021",2095,517448,1976344,764450,""
AL,"04/15/2021",3311,520759,2207392,893002,""
AL,"04/22/2021",3546,524305,2394304,1010415,""
AL,"04/29/2021",2780,527085,2559938,1121348,""
AL,"05/06/2021",2374,529459,2673181,1201303,""
AL,"05/13/2021",2289,531748,2831853,1314534,""
AL,"05/20/2021",9142,540890,2939161,1382327,""
AL,"05/27/2021",1938,542828,3007387,1423605,""
AL,"06/03/2021",1760,544588,3025695,1435719,""
AL,"06/10/2021",2241,546829,3064250,1460230,""
AL,"06/17/2021",1476,548305,3253283,1546119,""
AL,"06/24/2021",1091,549396,3308713,1574676,""
AL,"07/01/2021",1583,550979,3365396,1601802,""
AL,"07/08/2021",1932,552911,3402487,1623114,""
AL,"07/15/2021",3702,556613,3448153,1645083,""
AL,"07/22/2021",7331,563944,3494632,1662812,""
AL,"07/29/2021",13519,577463,3557966,1677279,""
AL,"08/05/2021",18353,595816,3651071,1697144,""
AL,"08/12/2021",23936,619752,3748680,1720455,""
AL,"08/19/2021",26099,645851,3857905,1759489,""
AL,"08/26/2021",19802,665653,3988529,1813256,0
AL,"09/02/2021",38767,704420,4158442,1891063,0
AL,"09/09/2021",27734,732154,4255847,1940044,0
AL,"09/16/2021",25739,757893,4359022,1997364,0
AL,"09/23/2021",20656,778549,4441961,2045238,0
AL,"09/30/2021",16224,794773,4532608,2089852,0
AL,"10/07/2021",9478,804251,4604007,2118943,0
AL,"10/14/2021",6249,810500,4669623,2144120,0
AL,"10/21/2021",5498,815998,4732829,2165154,134615
AL,"10/28/2021",12645,828643,4827200,2187378,186912
AL,"11/04/2021",4838,833481,4926067,2204677,247798
AL,"11/11/2021",3858,837339,4999699,2219423,290592
AL,"11/18/2021",3595,840934,5105635,2237829,350133
AL,"11/25/2021",3272,844206,5191035,2254666,393964
AL,"12/02/2021",2100,846306,5269173,2268570,434119
AL,"12/09/2021",3792,850098,5379834,2288180,495138
AL,"12/16/2021",4786,854884,5465558,2306267,542978
AL,"12/23/2021",6226,861110,5549319,2321403,591412
AL,"12/30/2021",19197,880307,5624234,2335344,632174
AL,"01/06/2022",51943,932250,5695747,2349085,668394
AL,"01/13/2022",72372,1004622,5771935,2363643,708033
AL,"01/20/2022",83748,1088370,5831563,2397146,736300
AL,"01/27/2022",73560,1161930,5935375,2418268,789208
AL,"02/03/2022",67370,1229300,5975361,2429527,806102
AL,"02/10/2022",24732,1254032,6007170,2440010,818351
AL,"02/17/2022",13876,1267908,6063958,2451886,830302
AL,"02/24/2022",7449,1275357,6087103,2459363,839556
AL,"03/03/2022",6249,1281606,6108052,2466221,847841
AL,"03/10/2022",6217,1287823,6124293,2471885,853746
AL,"03/17/2022",2315,1290138,6138900,2477117,858951
AL,"03/24/2022",1789,1291927,6149794,2480282,863092
AL,"03/31/2022",3088,1295015,6163615,2484171,868156
AL,"04/07/2022",1271,1296286,6189250,2488817,874229
AL,"04/14/2022",1106,1297392,6216804,2493334,879644
AL,"04/21/2022",1245,1298637,6251443,2500762,886245
AL,"04/28/2022",1637,1300274,6270477,2503983,890271
AL,"05/05/2022",1530,1301804,6290805,2507427,894412
AL,"05/12/2022",2023,1303827,6309333,2510739,898250
AL,"05/19/2022",2835,1306662,6330112,2514114,902534
AL,"05/26/2022",3859,1310521,6351550,2517736,906948
AL,"06/02/2022",5413,1315934,6368601,2520854,910788
AL,"06/09/2022",7023,1322957,6386398,2524132,915001
AL,"06/16/2022",8495,1331452,6402751,2527041,918815
AR,"12/17/2020",15451,192416,4,0,""
AR,"12/24/2020",14873,207289,19773,0,""
AR,"12/31/2020",15229,222518,33802,0,""
AR,"01/07/2021",19429,241947,40879,0,""
AR,"01/14/2021",19328,261275,118338,0,""
AR,"01/21/2021",14198,275473,173312,0,""
AR,"01/28/2021",12587,288060,252824,0,""
AR,"02/04/2021",11525,299585,338227,0,""
AR,"02/11/2021",9359,308944,430803,0,""
AR,"02/18/2021",4378,313322,490737,0,""
AR,"02/25/2021",3238,316560,572553,0,""
AR,"03/04/2021",7403,323963,704368,0,""
AR,"03/11/2021",2284,326247,800091,285811,""
AR,"03/18/2021",2067,328314,929862,324554,""
AR,"03/25/2021",1431,329745,1056307,366664,""
AR,"04/01/2021",1172,330917,1209965,432735,""
AR,"04/08/2021",1074,331991,1379591,518824,""
AR,"04/15/2021",1163,333154,1535135,606113,""
AR,"04/22/2021",1378,334532,1667028,683800,""
AR,"04/29/2021",1234,335766,1772085,754913,""
AR,"05/06/2021",1488,337254,1860521,813144,""
AR,"05/13/2021",1299,338553,1928682,859154,""
AR,"05/20/2021",1339,339892,1991127,894806,""
AR,"05/27/2021",1286,341178,2050759,925698,""
AR,"06/03/2021",992,342170,2089146,946639,""
AR,"06/10/2021",1251,343421,2130617,969859,""
AR,"06/17/2021",1741,345162,2168127,993850,""
AR,"06/24/2021",1908,347070,2200842,1013056,""
AR,"07/01/2021",2822,349892,2240617,1033763,""
AR,"07/08/2021",3771,353663,2269110,1046644,""
AR,"07/15/2021",7084,360747,2304153,1060174,""
AR,"07/22/2021",8272,369019,2354411,1074872,""
AR,"07/29/2021",12451,381470,2421801,1092321,""
AR,"08/05/2021",13834,395304,2509004,1121950,""
AR,"08/12/2021",16339,411643,2581762,1147261,""
AR,"08/19/2021",15039,426682,2664313,1183159,""
AR,"08/26/2021",15663,442345,2745701,1225762,0
AR,"09/02/2021",14878,457223,2822186,1267963,0
AR,"09/09/2021",11928,469151,2876898,1300042,0
AR,"09/16/2021",11569,480720,2931509,1332063,0
AR,"09/23/2021",9115,489835,2974638,1358170,0
AR,"09/30/2021",6819,496654,3018302,1375964,0
AR,"10/07/2021",5112,501766,3074757,1392755,0
AR,"10/14/2021",4615,506381,3120801,1406742,0
AR,"10/21/2021",3985,510366,3161353,1420440,95994
AR,"10/28/2021",3110,513476,3216545,1442790,129675
AR,"11/04/2021",3122,516598,3287738,1454573,175951
AR,"11/11/2021",3313,519911,3358664,1465088,219925
AR,"11/18/2021",4477,524388,3416560,1473064,251831
AR,"11/25/2021",3648,528036,3474961,1480277,286457
AR,"12/02/2021",3879,531915,3549259,1493672,326085
AR,"12/09/2021",5636,537551,3633151,1510981,373384
AR,"12/16/2021",4931,542482,3690809,1524211,405390
AR,"12/23/2021",5681,548163,3754611,1536411,441691
AR,"12/30/2021",11305,559468,3800076,1545513,467224
AR,"01/06/2022",30310,589778,3847782,1554295,492691
AR,"01/13/2022",50319,640097,3903085,1563487,523640
AR,"01/20/2022",62896,702993,3951478,1578650,550444
AR,"01/27/2022",46255,749248,3985893,1586373,568492
AR,"02/03/2022",30339,779587,4005835,1591841,577912
AR,"02/10/2022",9671,789258,4033703,1599938,590714
AR,"02/17/2022",9355,798613,4060791,1606459,598043
AR,"02/24/2022",6077,804690,4081816,1612690,607066
AR,"03/03/2022",3937,808627,4094036,1616163,612459
AR,"03/10/2022",2661,811288,4104598,1619551,616875
AR,"03/17/2022",2840,814128,4115482,1623014,621200
AR,"03/24/2022",3671,817799,4128209,1626593,626384
AR,"03/31/2022",868,818667,4134976,1628268,629516
AR,"04/07/2022",800,819467,4157758,1631579,634570
AR,"04/14/2022",866,820333,4181507,1634605,639147
AR,"04/21/2022",829,821162,4209797,1638155,644586
AR,"04/28/2022",1074,822236,4232797,1641408,649641
AR,"05/05/2022",1140,823376,4250249,1643845,652953
AR,"05/12/2022",1465,824841,4265281,1646482,656098
AR,"05/19/2022",1881,826722,4281102,1649083,659278
AR,"05/26/2022",2276,828998,4297198,1651557,662664
AR,"06/02/2022",2153,831151,4308639,1653457,665434
AR,"06/09/2022",3948,835099,4324520,1656070,668821
AR,"06/16/2022",4355,839454,4333404,1657535,671001
AS,"12/17/2020",0,0,0,0,""
AS,"12/24/2020",0,0,570,0,""
AS,"12/31/2020",0,0,972,0,""
AS,"01/07/2021",0,0,1161,0,""
AS,"01/14/2021",0,0,2971,0,""
AS,"01/21/2021",0,0,5664,0,""
AS,"01/28/2021",0,0,9085,0,""
AS,"02/04/2021",0,0,11257,0,""
AS,"02/11/2021",0,0,13513,0,""
AS,"02/18/2021",0,0,16269,0,""
AS,"02/25/2021",0,0,19739,0,""
AS,"03/04/2021",0,0,21625,0,""
AS,"03/11/2021",0,0,23696,8706,""
AS,"03/18/2021",0,0,24300,9025,""
AS,"03/25/2021",0,0,27864,10566,""
AS,"04/01/2021",0,0,31167,13406,""
AS,"04/08/2021",0,0,32904,14338,""
AS,"04/15/2021",0,0,34786,15239,""
AS,"04/22/2021",0,0,36093,15849,""
AS,"04/29/2021",0,0,38337,16914,""
AS,"05/06/2021",0,0,39268,17399,""
AS,"05/13/2021",0,0,40091,17911,""
AS,"05/20/2021",0,0,41461,18657,""
AS,"05/27/2021",0,0,42511,19250,""
AS,"06/03/2021",0,0,43052,19403,""
AS,"06/10/2021",0,0,43401,19591,""
AS,"06/17/2021",0,0,44646,20249,""
AS,"06/24/2021",0,0,45749,20792,""
AS,"07/01/2021",0,0,46780,21291,""
AS,"07/08/2021",0,0,47735,21714,""
AS,"07/15/2021",0,0,49122,22423,""
AS,"07/22/2021",0,0,50065,22868,""
AS,"07/29/2021",0,0,51670,23559,""
AS,"08/05/2021",0,0,52559,24043,""
AS,"08/12/2021",0,0,53169,24310,""
AS,"08/19/2021",0,0,54647,25091,""
AS,"08/26/2021",0,0,55562,25562,0
AS,"09/02/2021",0,0,55576,25574,0
AS,"09/09/2021",0,0,57755,26359,0
AS,"09/16/2021",0,0,58463,26666,0
AS,"09/23/2021",1,1,60516,27582,0
AS,"09/30/2021",0,1,62048,28433,0
AS,"10/07/2021",2,3,63123,29163,0
AS,"10/14/2021",0,3,63952,29791,0
AS,"10/21/2021",0,3,65441,30797,20
AS,"10/28/2021",1,4,65651,30937,62
AS,"11/04/2021",0,4,66045,31042,317
AS,"11/11/2021",0,4,66588,31182,621
AS,"11/18/2021",1,5,66939,31274,850
AS,"11/25/2021",0,5,67553,31351,1268
AS,"12/02/2021",5,10,67867,31395,1473
AS,"12/09/2021",0,10,71187,31594,2294
AS,"12/16/2021",0,10,73265,31826,2864
AS,"12/23/2021",1,11,74926,32029,3325
AS,"12/30/2021",0,11,75819,32705,3406
AS,"01/06/2022",0,11,79194,34947,3800
AS,"01/13/2022",7,18,81421,36121,4272
AS,"01/20/2022",0,18,82614,36601,4643
AS,"01/27/2022",0,18,83333,36947,4936
AS,"02/03/2022",4,22,84311,37547,5178
AS,"02/10/2022",35,57,85247,37890,5538
AS,"02/17/2022",0,57,85779,38024,5840
AS,"02/24/2022",15,72,86358,38167,6168
AS,"03/03/2022",74,146,88863,38450,8087
AS,"03/10/2022",206,352,93864,39008,11880
AS,"03/17/2022",427,779,99524,39734,16124
AS,"03/24/2022",1214,1993,102185,40116,18146
AS,"03/31/2022",1490,3483,104022,40484,19418
AS,"04/07/2022",1535,5018,105490,40756,20453
AS,"04/14/2022",518,5536,107224,41214,21535
AS,"04/21/2022",127,5663,107565,41283,21758
AS,"04/28/2022",154,5817,108332,41405,22161
AS,"05/05/2022",56,5873,109529,41615,22753
AS,"05/12/2022",118,5991,109971,41670,22963
AS,"05/19/2022",74,6065,110403,41752,23156
AS,"05/26/2022",45,6110,110671,41796,23276
AS,"06/02/2022",82,6192,110979,41839,23403
AS,"06/09/2022",0,6192,111252,41889,23495
AS,"06/16/2022",78,6270,111347,41903,23527
AZ,"12/17/2020",46684,429285,3,0,""
AZ,"12/24/2020",43988,473273,16701,0,""
AZ,"12/31/2020",39216,512489,43667,0,""
AZ,"01/07/2021",62191,574680,88266,0,""
AZ,"01/14/2021",67049,641729,173665,0,""
AZ,"01/21/2021",48815,690544,303899,0,""
AZ,"01/28/2021",48017,738561,487149,0,""
AZ,"02/04/2021",28818,767379,686116,0,""
AZ,"02/11/2021",21883,789262,941575,0,""
AZ,"02/18/2021",11793,801055,1202770,0,""
AZ,"02/25/2021",10913,811968,1607544,0,""
AZ,"03/04/2021",7848,819816,1979929,0,""
AZ,"03/11/2021",8652,828468,2350374,792205,""
AZ,"03/18/2021",5391,833859,2755436,978991,""
AZ,"03/25/2021",3969,837828,3106598,1108397,""
AZ,"04/01/2021",3979,841807,3512579,1267484,""
AZ,"04/08/2021",4424,846231,3901177,1453432,""
AZ,"04/15/2021",5034,851265,4306602,1670496,""
AZ,"04/22/2021",4539,855804,4688598,1883233,""
AZ,"04/29/2021",4968,860772,5024348,2078095,""
AZ,"05/06/2021",5236,866008,5259733,2222457,""
AZ,"05/13/2021",4603,870611,5497137,2380200,""
AZ,"05/20/2021",3951,874562,5687093,2482237,""
AZ,"05/27/2021",3750,878312,5879403,2579485,""
AZ,"06/03/2021",3868,882180,5997066,2638935,""
AZ,"06/10/2021",2822,885002,6122967,2709020,""
AZ,"06/17/2021",2971,887973,6292764,2808680,""
AZ,"06/24/2021",3052,891025,6394880,2865109,""
AZ,"07/01/2021",3847,894872,6768593,3140316,""
AZ,"07/08/2021",3411,898283,6842949,3181391,""
AZ,"07/15/2021",5568,903851,6918832,3221874,""
AZ,"07/22/2021",7611,911462,6988716,3254456,""
AZ,"07/29/2021",9983,921445,7068316,3283173,""
AZ,"08/05/2021",14202,935647,7160555,3314379,""
AZ,"08/12/2021",17150,952797,7253931,3348704,""
AZ,"08/19/2021",20128,972925,7361667,3394936,""
AZ,"08/26/2021",18384,991309,7489034,3448771,0
AZ,"09/02/2021",25354,1016663,7602465,3499085,0
AZ,"09/09/2021",20350,1037013,7924996,3592704,0
AZ,"09/16/2021",18906,1055919,8029150,3639739,0
AZ,"09/23/2021",16944,1072863,8119649,3683438,0
AZ,"09/30/2021",17976,1090839,8214287,3718393,0
AZ,"10/07/2021",17991,1108830,8343353,3754440,0
AZ,"10/14/2021",15879,1124709,8464145,3788304,0
AZ,"10/21/2021",14918,1139627,8578327,3819100,234894
AZ,"10/28/2021",17104,1156731,8727934,3851270,313855
AZ,"11/04/2021",18789,1175520,8893654,3881149,413201
AZ,"11/11/2021",23757,1199277,9070317,3910633,513092
AZ,"11/18/2021",24615,1223892,9274451,3939188,612944
AZ,"11/25/2021",28356,1252248,9458251,3961885,707024
AZ,"12/02/2021",20695,1272943,9670070,3995852,816828
AZ,"12/09/2021",28655,1301598,9908217,4043529,939650
AZ,"12/16/2021",22399,1323997,10140601,4090649,1055725
AZ,"12/23/2021",20186,1344183,10336743,4123464,1162746
AZ,"12/30/2021",23897,1368080,10491351,4149298,1245470
AZ,"01/06/2022",51482,1419562,10637900,4176104,1321221
AZ,"01/13/2022",104801,1524363,10818113,4207031,1414675
AZ,"01/20/2022",141828,1666191,10971347,4243285,1494929
AZ,"01/27/2022",133312,1799503,11104916,4266592,1562692
AZ,"02/03/2022",87038,1886541,11224516,4291956,1618865
AZ,"02/10/2022",45101,1931642,11335833,4321178,1661770
AZ,"02/17/2022",25443,1957085,11443192,4345647,1692335
AZ,"02/24/2022",14593,1971678,11508661,4364444,1717119
AZ,"03/03/2022",5212,1976890,11569674,4381765,1739485
AZ,"03/10/2022",10428,1987318,11617378,4394704,1756454
AZ,"03/17/2022",5153,1992471,11662231,4406487,1771872
AZ,"03/24/2022",4566,1997037,11729275,4426324,1790990
AZ,"03/31/2022",10143,2007180,11762910,4434102,1802786
AZ,"04/07/2022",6828,2014008,11840016,4443840,1819640
AZ,"04/14/2022",2721,2016729,11931113,4453558,1837594
AZ,"04/21/2022",2437,2019166,12032371,4469891,1857541
AZ,"04/28/2022",2358,2021524,12103243,4478221,1871498
AZ,"05/05/2022",3911,2025435,12167840,4485933,1884277
AZ,"05/12/2022",5490,2030925,12230590,4494479,1897297
AZ,"05/19/2022",7204,2038129,12285388,4500891,1908431
AZ,"05/26/2022",11498,2049627,12355928,4508947,1921796
AZ,"06/02/2022",13042,2062669,12407069,4515289,1933840
AZ,"06/09/2022",14677,2077346,12459198,4521912,1946428
AZ,"06/16/2022",16334,2093680,12537556,4532807,1964528
CA,"12/17/2020",263456,1725293,273,0,""
CA,"12/24/2020",305346,2030639,174110,0,""
CA,"12/31/2020",271394,2302033,333373,0,""
CA,"01/07/2021",280190,2582223,528173,0,""
CA,"01/14/2021",311715,2893938,975293,0,""
CA,"01/21/2021",247717,3141655,1633875,0,""
CA,"01/28/2021",158085,3299740,2746876,0,""
CA,"02/04/2021",116793,3416533,3723803,0,""
CA,"02/11/2021",85768,3502301,5134864,0,""
CA,"02/18/2021",55859,3558160,6496140,0,""
CA,"02/25/2021",41568,3599728,8064121,0,""
CA,"03/04/2021",31409,3631137,9860209,0,""
CA,"03/11/2021",30321,3661458,11220508,3541495,""
CA,"03/18/2021",20425,3681883,13563094,4517256,""
CA,"03/25/2021",19942,3701825,16062266,5481297,""
CA,"04/01/2021",18777,3720602,18604164,6485628,""
CA,"04/08/2021",19249,3739851,21243518,7599559,""
CA,"04/15/2021",22245,3762096,24242205,8959332,""
CA,"04/22/2021",16765,3778861,27384986,10493528,""
CA,"04/29/2021",13730,3792591,29957450,11796688,""
CA,"05/06/2021",13050,3805641,31997303,13017480,""
CA,"05/13/2021",12391,3818032,34085597,14471012,""
CA,"05/20/2021",9853,3827885,36053888,15717779,""
CA,"05/27/2021",8675,3836560,37669020,16664687,""
CA,"06/03/2021",10462,3847022,38637246,17205248,""
CA,"06/10/2021",6655,3853677,39765872,17903416,""
CA,"06/17/2021",6091,3859768,41042422,18751239,""
CA,"06/24/2021",6574,3866342,41839888,19213533,""
CA,"07/01/2021",8885,3875227,42771685,19746626,""
CA,"07/08/2021",11566,3886793,43307094,20016280,""
CA,"07/15/2021",21654,3908447,43868821,20309600,""
CA,"07/22/2021",36201,3944648,44375374,20553610,""
CA,"07/29/2021",53665,3998313,44934366,20792219,""
CA,"08/05/2021",72029,4070342,45571605,21054022,""
CA,"08/12/2021",85690,4156032,46165206,21293344,""
CA,"08/19/2021",94842,4250874,46827191,21559379,""
CA,"08/26/2021",94848,4345722,47513370,21853184,0
CA,"09/02/2021",106976,4452698,48220341,22167559,0
CA,"09/09/2021",75232,4527930,48768666,22423380,0
CA,"09/16/2021",70831,4598761,49388334,22731897,0
CA,"09/23/2021",58633,4657394,50100113,23093239,0
CA,"09/30/2021",52063,4709457,50639664,23302641,0
CA,"10/07/2021",45783,4755240,51458972,23536277,0
CA,"10/14/2021",39795,4795035,52177437,23734748,0
CA,"10/21/2021",37626,4832661,52869188,23923585,1381200
CA,"10/28/2021",44167,4876828,53719846,24126229,1831761
CA,"11/04/2021",43068,4919896,54856323,24321573,2539744
CA,"11/11/2021",43531,4963427,55978004,24498908,3158797
CA,"11/18/2021",36600,5000027,57552889,24692255,3970547
CA,"11/25/2021",35113,5035140,58715000,24827738,4624112
CA,"12/02/2021",32117,5067257,60030910,25059980,5353570
CA,"12/09/2021",49647,5116904,61693063,25429366,6258488
CA,"12/16/2021",43870,5160774,63218101,25742732,7113800
CA,"12/23/2021",65862,5226636,64690197,25970014,7985668
CA,"12/30/2021",185504,5412140,65589033,26105670,8505080
CA,"01/06/2022",420444,5832584,66900191,26324995,9256911
CA,"01/13/2022",790954,6623538,68198299,26526203,10014068
CA,"01/20/2022",788494,7412032,69549938,26949777,10735572
CA,"01/27/2022",708364,8120396,68753647,27195305,12097297
CA,"02/03/2022",396396,8516792,69566351,27354924,12536435
CA,"02/10/2022",209866,8726658,70204178,27502666,12850826
CA,"02/17/2022",113165,8839823,70881293,27662976,13074551
CA,"02/24/2022",74290,8914113,71306336,27773615,13266791
CA,"03/03/2022",54026,8968139,71671126,27867605,13507985
CA,"03/10/2022",46754,9014893,71979632,27941666,13638595
CA,"03/17/2022",19736,9034629,72240851,28009145,13745440
CA,"03/24/2022",31218,9065847,72454498,28057264,13845738
CA,"03/31/2022",18983,9084830,72651052,28100914,13934071
CA,"04/07/2022",20318,9105148,73084268,28151525,14035604
CA,"04/14/2022",9765,9114913,73790862,28284798,14188826
CA,"04/21/2022",40145,9155058,74469932,28400258,14326263
CA,"04/28/2022",43476,9198534,74886586,28448691,14410612
CA,"05/05/2022",48470,9247004,75301643,28489541,14493339
CA,"05/12/2022",60410,9307414,75582187,28593661,15015263
CA,"05/19/2022",77897,9385311,75982004,28627057,15096325
CA,"05/26/2022",108013,9493324,76413202,28662542,15193731
CA,"06/02/2022",109178,9602502,76757440,28693693,15301159
CA,"06/09/2022",114609,9717111,77098230,28724839,15403543
CA,"06/16/2022",121961,9839072,77391976,28752801,15494774
CO,"12/17/2020",22623,316536,351,0,""
CO,"12/24/2020",17252,333788,43762,0,""
CO,"12/31/2020",13697,347485,82694,0,""
CO,"01/07/2021",16083,363568,130379,0,""
CO,"01/14/2021",16469,380037,254706,0,""
CO,"01/21/2021",11987,392024,353194,0,""
CO,"01/28/2021",10395,402419,495706,0,""
CO,"02/04/2021",9245,411664,638923,0,""
CO,"02/11/2021",8790,420454,815108,0,""
CO,"02/18/2021",7040,427494,1053041,0,""
CO,"02/25/2021",7664,435158,1294236,0,""
CO,"03/04/2021",7290,442448,1494910,0,""
CO,"03/11/2021",6816,449264,1764066,640244,""
CO,"03/18/2021",6403,455667,2029213,765933,""
CO,"03/25/2021",7929,463596,2388899,912807,""
CO,"04/01/2021",8707,472303,2746030,1028324,""
CO,"04/08/2021",10504,482807,3129702,1181330,""
CO,"04/15/2021",11029,493836,3583563,1379177,""
CO,"04/22/2021",11739,505575,4003990,1596141,""
CO,"04/29/2021",11892,517467,4388497,1824323,""
CO,"05/06/2021",10170,527637,4711738,2045903,""
CO,"05/13/2021",8872,536509,5015042,2271616,""
CO,"05/20/2021",6011,542520,5285343,2435657,""
CO,"05/27/2021",5333,547853,5519571,2559111,""
CO,"06/03/2021",3319,551172,5662462,2637501,""
CO,"06/10/2021",3135,554307,5805820,2728692,""
CO,"06/17/2021",2454,556761,5978822,2847420,""
CO,"06/24/2021",2284,559045,6089509,2917366,""
CO,"07/01/2021",2421,561466,6203544,2992902,""
CO,"07/08/2021",2399,563865,6265592,3030014,""
CO,"07/15/2021",3061,566926,6331710,3066574,""
CO,"07/22/2021",3841,570767,6388375,3096731,""
CO,"07/29/2021",5201,575968,6449405,3123919,""
CO,"08/05/2021",6573,582541,6520732,3152572,""
CO,"08/12/2021",7658,590199,6587689,3179819,""
CO,"08/19/2021",9127,599326,6670461,3214152,""
CO,"08/26/2021",11494,610820,6754208,3251094,0
CO,"09/02/2021",12624,623444,6838786,3284900,0
CO,"09/09/2021",12341,635785,6924521,3320862,0
CO,"09/16/2021",14222,650007,7011329,3356631,0
CO,"09/23/2021",13155,663162,7086638,3389188,0
CO,"09/30/2021",13084,676246,7177109,3419720,0
CO,"10/07/2021",14731,690977,7292850,3451022,0
CO,"10/14/2021",15588,706565,7399472,3479166,0
CO,"10/21/2021",15489,722054,7499427,3506463,279350
CO,"10/28/2021",19241,741295,7651943,3537500,379441
CO,"11/04/2021",21058,762353,7839543,3561456,517803
CO,"11/11/2021",24528,786881,8031754,3583434,644230
CO,"11/18/2021",24094,810975,8284177,3605359,794794
CO,"11/25/2021",20435,831410,8488178,3623786,925447
CO,"12/02/2021",16604,848014,8678461,3655321,1040424
CO,"12/09/2021",16173,864187,8940101,3715279,1193603
CO,"12/16/2021",12104,876291,9159836,3759966,1326871
CO,"12/23/2021",19424,895715,9374761,3790915,1465275
CO,"12/30/2021",49423,945138,9517277,3813580,1553333
CO,"01/06/2022",91524,1036662,9619008,3830901,1613351
CO,"01/13/2022",121228,1157890,9773007,3855340,1708996
CO,"01/20/2022",104379,1262269,9899278,3900142,1786515
CO,"01/27/2022",71664,1333933,10011967,3918538,1854563
CO,"02/03/2022",38223,1372156,10092633,3935264,1898686
CO,"02/10/2022",19174,1391330,10159100,3953769,1933113
CO,"02/17/2022",10643,1401973,10254785,3969935,1959897
CO,"02/24/2022",6177,1408150,10299034,3980992,1980746
CO,"03/03/2022",4738,1412888,10335987,3990440,1997377
CO,"03/10/2022",3315,1416203,10368780,3998681,2012065
CO,"03/17/2022",2940,1419143,10396327,4005753,2023645
CO,"03/24/2022",2387,1421530,10422016,4011858,2035596
CO,"03/31/2022",2316,1423846,10444612,4016838,2045265
CO,"04/07/2022",2595,1426441,10504096,4023070,2056820
CO,"04/14/2022",3100,1429541,10575091,4029386,2068682
CO,"04/21/2022",4433,1433974,10644381,4036754,2083696
CO,"04/28/2022",5218,1439192,10705204,4042299,2094241
CO,"05/05/2022",6811,1446003,10757510,4047425,2103565
CO,"05/12/2022",8901,1454904,10807143,4052172,2112927
CO,"05/19/2022",11045,1465949,10853608,4056730,2121691
CO,"05/26/2022",12565,1478514,10909579,4061592,2133271
CO,"06/02/2022",13509,1492023,10952827,4065348,2143167
CO,"06/09/2022",17155,1509178,11022408,4071206,2156538
CO,"06/16/2022",15486,1524664,11068356,4074356,2165842
CT,"12/17/2020",17233,157781,2790,0,""
CT,"12/24/2020",12924,170705,20679,0,""
CT,"12/31/2020",12958,183663,68040,0,""
CT,"01/07/2021",15791,199454,109216,0,""
CT,"01/14/2021",21122,220576,180085,0,""
CT,"01/21/2021",13558,234134,264707,0,""
CT,"01/28/2021",13205,247339,381160,0,""
CT,"02/04/2021",9665,257004,481826,0,""
CT,"02/11/2021",8492,265496,600249,0,""
CT,"02/18/2021",4871,270367,767183,0,""
CT,"02/25/2021",5338,275705,925946,0,""
CT,"03/04/2021",5703,281408,1087313,0,""
CT,"03/11/2021",5382,286790,1304302,362671,""
CT,"03/18/2021",6230,293020,1514945,543501,""
CT,"03/25/2021",7144,300164,1737160,632200,""
CT,"04/01/2021",9122,309286,1992899,743564,""
CT,"04/08/2021",8806,318092,2279517,887812,""
CT,"04/15/2021",7754,325846,2612551,1058759,""
CT,"04/22/2021",6953,332799,2913574,1200180,""
CT,"04/29/2021",5670,338469,3184543,1350870,""
CT,"05/06/2021",3920,342389,3398443,1493571,""
CT,"05/13/2021",2163,344552,3612792,1656431,""
CT,"05/20/2021",1238,345790,3805000,1775334,""
CT,"05/27/2021",1190,346980,3968265,1868188,""
CT,"06/03/2021",698,347678,4059343,1922629,""
CT,"06/10/2021",584,348262,4171732,1999526,""
CT,"06/17/2021",299,348561,4276700,2075632,""
CT,"06/24/2021",279,348840,4339850,2115931,""
CT,"07/01/2021",513,349353,4414112,2167566,""
CT,"07/08/2021",391,349744,4451999,2188840,""
CT,"07/15/2021",643,350387,4493769,2211353,""
CT,"07/22/2021",1143,351530,4534381,2231811,""
CT,"07/29/2021",1975,353505,4577225,2249771,""
CT,"08/05/2021",3196,356701,4620673,2267356,""
CT,"08/12/2021",3851,360552,4667990,2286455,""
CT,"08/19/2021",4339,364891,4721389,2309829,""
CT,"08/26/2021",4241,369132,4778412,2333880,0
CT,"09/02/2021",4652,373784,4839352,2360741,0
CT,"09/09/2021",3898,377682,4880740,2380402,0
CT,"09/16/2021",4050,381732,4930647,2405018,0
CT,"09/23/2021",4940,386672,4980413,2430419,0
CT,"09/30/2021",3508,390180,5039727,2449489,0
CT,"10/07/2021",2771,392951,5122227,2468665,0
CT,"10/14/2021",2770,395721,5195177,2485202,0
CT,"10/21/2021",3642,399363,5265418,2500835,159353
CT,"10/28/2021",2353,401716,5357571,2515556,216444
CT,"11/04/2021",2502,404218,5489331,2528365,305269
CT,"11/11/2021",2534,406752,5619704,2540074,388197
CT,"11/18/2021",4559,411311,5766727,2550060,468851
CT,"11/25/2021",5262,416573,5898047,2558052,548090
CT,"12/02/2021",6212,422785,6036671,2573654,634614
CT,"12/09/2021",10679,433464,6205565,2607228,734727
CT,"12/16/2021",18574,452038,6375605,2633881,842035
CT,"12/23/2021",19103,471141,6529401,2649289,940949
CT,"12/30/2021",31343,502484,6638228,2659830,1009004
CT,"01/06/2022",52328,554812,6765316,2675408,1084172
CT,"01/13/2022",64373,619185,6890321,2693093,1157329
CT,"01/20/2022",47520,666705,6996233,2710857,1221045
CT,"01/27/2022",26856,693561,7065025,2722828,1258849
CT,"02/03/2022",16832,710393,7124391,2735682,1290300
CT,"02/10/2022",8143,718536,7188727,2750727,1323460
CT,"02/17/2022",5529,724065,7238519,2761748,1345381
CT,"02/24/2022",3775,727840,7277732,2771081,1364875
CT,"03/03/2022",2585,730425,7303061,2776417,1377746
CT,"03/10/2022",2067,732492,7328468,2782071,1390905
CT,"03/17/2022",1893,734385,7351934,2786975,1403622
CT,"03/24/2022",2151,736536,7370693,2790867,1413620
CT,"03/31/2022",2601,739137,7391071,2795202,1424433
CT,"04/07/2022",3150,742287,7441776,2802153,1434820
CT,"04/14/2022",3776,746063,7500294,2809276,1442559
CT,"04/21/2022",4742,750805,7552008,2815499,1449397
CT,"04/28/2022",5166,755971,7598707,2821249,1455723
CT,"05/05/2022",7178,763149,7639835,2826170,1461627
CT,"05/12/2022",13917,777066,7678275,2831156,1467212
CT,"05/19/2022",12200,789266,7716994,2836168,1472969
CT,"05/26/2022",11240,800506,7758450,2841714,1479930
CT,"06/02/2022",8340,808846,7785706,2845136,1485230
CT,"06/09/2022",6111,814957,7812564,2848698,1491576
CT,"06/16/2022",6794,821751,7832263,2851549,1495949
DC,"12/17/2020",1748,25602,0,0,""
DC,"12/24/2020",1624,27226,5567,0,""
DC,"12/31/2020",1532,28758,13167,0,""
DC,"01/07/2021",1724,30482,21681,0,""
DC,"01/14/2021",2118,32600,36679,0,""
DC,"01/21/2021",1803,34403,55108,0,""
DC,"01/28/2021",1462,35865,70839,0,""
DC,"02/04/2021",1334,37199,94095,0,""
DC,"02/11/2021",1149,38348,111720,0,""
DC,"02/18/2021",832,39180,130437,0,""
DC,"02/25/2021",763,39943,173030,0,""
DC,"03/04/2021",875,40818,207421,0,""
DC,"03/11/2021",1188,42006,244060,56459,""
DC,"03/18/2021",805,42811,285546,69819,""
DC,"03/25/2021",784,43595,320173,79733,""
DC,"04/01/2021",918,44513,381345,100548,""
DC,"04/08/2021",815,45328,426808,121675,""
DC,"04/15/2021",881,46209,481913,153091,""
DC,"04/22/2021",732,46941,539240,178088,""
DC,"04/29/2021",592,47533,595665,206340,""
DC,"05/06/2021",508,48041,631309,227589,""
DC,"05/13/2021",295,48336,685996,261129,""
DC,"05/20/2021",298,48634,739546,297401,""
DC,"05/27/2021",188,48822,774198,318874,""
DC,"06/03/2021",189,49011,792734,328856,""
DC,"06/10/2021",116,49127,809582,338846,""
DC,"06/17/2021",96,49223,832077,352381,""
DC,"06/24/2021",61,49284,848202,359956,""
DC,"07/01/2021",71,49355,865044,369251,""
DC,"07/08/2021",68,49423,875639,374803,""
DC,"07/15/2021",151,49574,884367,378875,""
DC,"07/22/2021",284,49858,891351,382126,""
DC,"07/29/2021",410,50268,898319,385290,""
DC,"08/05/2021",590,50858,906650,388761,""
DC,"08/12/2021",995,51853,918901,394566,""
DC,"08/19/2021",1171,53024,928482,397952,""
DC,"08/26/2021",1132,54156,938980,401605,0
DC,"09/02/2021",1414,55570,950386,405386,0
DC,"09/09/2021",1124,56694,963047,410336,0
DC,"09/16/2021",1746,58440,974666,415543,0
DC,"09/23/2021",1409,59849,985028,419644,0
DC,"09/30/2021",1147,60996,999174,424467,0
DC,"10/07/2021",982,61978,1013795,428039,0
DC,"10/14/2021",772,62750,1027501,431805,0
DC,"10/21/2021",650,63400,1040743,435248,20693
DC,"10/28/2021",590,63990,1055543,439077,25761
DC,"11/04/2021",612,64602,1085640,443408,39229
DC,"11/11/2021",557,65159,1106153,446544,49350
DC,"11/18/2021",634,65793,1132019,449491,59845
DC,"11/25/2021",717,66510,1154472,452301,69809
DC,"12/02/2021",537,67047,1169902,456802,77511
DC,"12/09/2021",1215,68262,1198840,463548,89942
DC,"12/16/2021",1605,69867,1231252,469345,103571
DC,"12/23/2021",7794,77661,1263514,473965,118000
DC,"12/30/2021",14384,92045,1286502,476822,128214
DC,"01/06/2022",14774,106819,1306181,479314,136662
DC,"01/13/2022",11983,118802,1328116,483001,145807
DC,"01/20/2022",7385,126187,1347167,489687,152950
DC,"01/27/2022",3292,129479,1362855,492583,158909
DC,"02/03/2022",1614,131093,1376205,495345,163549
DC,"02/10/2022",1535,132628,1386943,498176,167273
DC,"02/17/2022",831,133459,1404033,501112,170934
DC,"02/24/2022",655,134114,1412520,503427,173522
DC,"03/03/2022",564,134678,1422840,505923,176891
DC,"03/10/2022",408,135086,1429546,507547,179012
DC,"03/17/2022",489,135575,1437075,508942,181517
DC,"03/24/2022",487,136062,1451275,512641,184326
DC,"03/31/2022",536,136598,1457927,514135,186773
DC,"04/07/2022",1005,137603,1469980,516268,189761
DC,"04/14/2022",1557,139160,1482541,518382,192640
DC,"04/21/2022",1514,140674,1496391,520427,195734
DC,"04/28/2022",1269,141943,1508029,522640,198873
DC,"05/05/2022",0,141943,1581621,547740,219006
DC,"05/12/2022",1062,143005,1590580,549407,221148
DC,"05/19/2022",3158,146163,1599835,551007,223262
DC,"05/26/2022",2107,148270,1610503,553013,226108
DC,"06/02/2022",2033,150303,1620438,554904,228891
DC,"06/09/2022",1675,151978,1568286,534191,214665
DC,"06/16/2022",1458,153436,1576748,535936,217066
DE,"12/17/2020",5939,48830,0,0,""
DE,"12/24/2020",4344,53174,4959,0,""
DE,"12/31/2020",4508,57682,9584,0,""
DE,"01/07/2021",5635,63317,16677,0,""
DE,"01/14/2021",5247,68564,31090,0,""
DE,"01/21/2021",4538,73102,49369,0,""
DE,"01/28/2021",3958,77060,82289,0,""
DE,"02/04/2021",2729,79789,110784,0,""
DE,"02/11/2021",2756,82545,133370,0,""
DE,"02/18/2021",2026,84571,159845,0,""
DE,"02/25/2021",1891,86462,195534,0,""
DE,"03/04/2021",1892,88354,246194,0,""
DE,"03/11/2021",1400,89754,299695,108208,""
DE,"03/18/2021",1399,91153,354571,125907,""
DE,"03/25/2021",1507,92660,406635,138495,""
DE,"04/01/2021",2123,94783,473912,163586,""
DE,"04/08/2021",2102,96885,536623,187560,""
DE,"04/15/2021",2430,99315,612195,229230,""
DE,"04/22/2021",2330,101645,682998,268625,""
DE,"04/29/2021",1731,103376,748392,309366,""
DE,"05/06/2021",1449,104825,793463,338973,""
DE,"05/13/2021",1000,105825,846379,372385,""
DE,"05/20/2021",772,106597,876335,389174,""
DE,"05/27/2021",578,107175,916936,409468,""
DE,"06/03/2021",352,107527,947021,425004,""
DE,"06/10/2021",290,107817,969254,438882,""
DE,"06/17/2021",213,108030,997058,458078,""
DE,"06/24/2021",152,108182,1015607,470185,""
DE,"07/01/2021",142,108324,1041382,488301,""
DE,"07/08/2021",165,108489,1052238,494517,""
DE,"07/15/2021",274,108763,1063514,500817,""
DE,"07/22/2021",326,109089,1073943,506457,""
DE,"07/29/2021",503,109592,1085633,511621,""
DE,"08/05/2021",922,110514,1098339,516584,""
DE,"08/12/2021",1472,111986,1110361,521087,""
DE,"08/19/2021",2101,114087,1124885,526710,""
DE,"08/26/2021",2307,116394,1140472,533348,0
DE,"09/02/2021",2683,119077,1156347,540571,0
DE,"09/09/2021",2586,121663,1167634,546061,0
DE,"09/16/2021",3270,124933,1176206,550338,0
DE,"09/23/2021",3261,128194,1188342,556034,0
DE,"09/30/2021",3025,131219,1202549,561269,0
DE,"10/07/2021",3193,134412,1229897,567487,0
DE,"10/14/2021",2781,137193,1248188,572172,0
DE,"10/21/2021",2364,139557,1268810,577295,37414
DE,"10/28/2021",1945,141502,1290314,581375,50594
DE,"11/04/2021",1734,143236,1323940,585615,72422
DE,"11/11/2021",1736,144972,1349240,589133,88017
DE,"11/18/2021",2239,147211,1386194,593241,107445
DE,"11/25/2021",2591,149802,1387212,593295,108625
DE,"12/02/2021",2768,152570,1455576,601627,145338
DE,"12/09/2021",4084,156654,1496481,609215,167222
DE,"12/16/2021",4392,161046,1533145,616331,187213
DE,"12/23/2021",5572,166618,1564474,621891,204599
DE,"12/30/2021",9645,176263,1582493,624808,214266
DE,"01/06/2022",18068,194331,1600324,627808,223701
DE,"01/13/2022",23976,218307,1628484,632523,238895
DE,"01/20/2022",14962,233269,1650688,639346,251224
DE,"01/27/2022",11058,244327,1673738,643213,263846
DE,"02/03/2022",5078,249405,1688410,646255,271299
DE,"02/10/2022",2791,252196,1705484,650563,278954
DE,"02/17/2022",1759,253955,1720307,654010,283353
DE,"02/24/2022",1023,254978,1729273,656886,286641
DE,"03/03/2022",694,255672,1735453,659134,288878
DE,"03/10/2022",624,256296,1742565,661447,291440
DE,"03/17/2022",452,256748,1747068,662913,292907
DE,"03/24/2022",426,257174,1751749,664214,294550
DE,"03/31/2022",496,257670,1755500,665413,295834
DE,"04/07/2022",628,258298,1768002,667236,298275
DE,"04/14/2022",885,259183,1785258,669389,301487
DE,"04/21/2022",1113,260296,1798191,670997,303765
DE,"04/28/2022",1326,261622,1809285,672434,305851
DE,"05/05/2022",1798,263420,1819856,673844,307744
DE,"05/12/2022",2758,266178,1829918,675232,309609
DE,"05/19/2022",3955,270133,1840555,676649,311595
DE,"05/26/2022",3912,274045,1852061,678121,313989
DE,"06/02/2022",3023,277068,1861083,679266,315898
DE,"06/09/2022",2502,279570,1869030,680379,317632
DE,"06/16/2022",1838,281408,1874040,681136,318845
FL,"12/17/2020",65830,1084358,2540,0,""
FL,"12/24/2020",74172,1158530,68273,0,""
FL,"12/31/2020",75332,1233862,213031,0,""
FL,"01/07/2021",83762,1317624,402802,0,""
FL,"01/14/2021",102769,1420393,853081,0,""
FL,"01/21/2021",97100,1517493,1239975,0,""
FL,"01/28/2021",77951,1595444,1707251,0,""
FL,"02/04/2021",69913,1665357,2223754,0,""
FL,"02/11/2021",62801,1728158,2957730,0,""
FL,"02/18/2021",49747,1777905,3819224,0,""
FL,"02/25/2021",42123,1820028,4605201,0,""
FL,"03/04/2021",41288,1861316,5314200,0,""
FL,"03/11/2021",36240,1897556,6332072,2179625,""
FL,"03/18/2021",31882,1929438,7522691,2630843,""
FL,"03/25/2021",31192,1960630,8603007,3002731,""
FL,"04/01/2021",34272,1994902,9781739,3490647,""
FL,"04/08/2021",37579,2032481,11101262,4111383,""
FL,"04/15/2021",40569,2073050,12550868,4819498,""
FL,"04/22/2021",44109,2117159,13856952,5458313,""
FL,"04/29/2021",38931,2156090,15013785,6136199,""
FL,"05/06/2021",37230,2193320,15893169,6664283,""
FL,"05/13/2021",29800,2223120,16937994,7359406,""
FL,"05/20/2021",23603,2246723,17744573,7842314,""
FL,"05/27/2021",18679,2265402,18442633,8205341,""
FL,"06/03/2021",15938,2281340,18912564,8468675,""
FL,"06/10/2021",11407,2292747,19490341,8814001,""
FL,"06/17/2021",12032,2304779,20202600,9302225,""
FL,"06/24/2021",10647,2315426,20612298,9545070,""
FL,"07/01/2021",11999,2327425,21113090,9868893,""
FL,"07/08/2021",16126,2343551,21392467,10015837,""
FL,"07/15/2021",23301,2366852,21687158,10166351,""
FL,"07/22/2021",45734,2412586,22012651,10320953,""
FL,"07/29/2021",73727,2486313,22411671,10456350,""
FL,"08/05/2021",111749,2598062,22883216,10588372,""
FL,"08/12/2021",136756,2734818,23345223,10720783,""
FL,"08/19/2021",153030,2887848,23892181,10926175,""
FL,"08/26/2021",151125,3038973,24385811,11138433,0
FL,"09/02/2021",153270,3192243,25072227,11468372,0
FL,"09/09/2021",132781,3325024,25535858,11691263,0
FL,"09/16/2021",99432,3424456,26016494,11934140,0
FL,"09/23/2021",76142,3500598,26392751,12130630,0
FL,"09/30/2021",54894,3555492,26780337,12301042,0
FL,"10/07/2021",38398,3593890,27226376,12453971,0
FL,"10/14/2021",26080,3619970,27602930,12584219,0
FL,"10/21/2021",19983,3639953,27897250,12676687,892426
FL,"10/28/2021",15634,3655587,28354807,12793276,1142257
FL,"11/04/2021",13257,3668844,28838525,12872953,1446954
FL,"11/11/2021",11503,3680347,29381758,12955558,1765624
FL,"11/18/2021",10694,3691041,30018517,13042051,2116430
FL,"11/25/2021",11384,3702425,30501707,13100793,2406202
FL,"12/02/2021",9998,3712423,31170744,13227652,2778893
FL,"12/09/2021",11389,3723812,31740679,13322860,3131987
FL,"12/16/2021",14269,3738081,32567919,13460713,3625154
FL,"12/23/2021",34018,3772099,33172989,13541346,3991202
FL,"12/30/2021",128180,3900279,33644593,13607439,4263127
FL,"01/06/2022",296317,4196596,34002943,13659557,4465318
FL,"01/13/2022",393739,4590335,34567794,13744395,4778139
FL,"01/20/2022",428470,5018805,34854962,13866645,4938723
FL,"01/27/2022",287147,5305952,35235521,13943699,5124088
FL,"02/03/2022",197461,5503413,35460085,14004494,5219017
FL,"02/10/2022",129764,5633177,35653792,14059401,5296694
FL,"02/17/2022",99839,5733016,35914858,14106658,5355274
FL,"02/24/2022",42329,5775345,36035360,14140484,5400659
FL,"03/03/2022",25501,5800846,36180421,14178300,5456573
FL,"03/10/2022",14108,5814954,36287516,14207223,5499648
FL,"03/17/2022",10223,5825177,36371536,14229442,5531796
FL,"03/24/2022",8024,5833201,36462698,14251619,5566050
FL,"03/31/2022",8813,5842014,36547754,14271700,5595946
FL,"04/07/2022",10156,5852170,36773478,14297672,5642940
FL,"04/14/2022",11276,5863446,37021321,14324361,5688740
FL,"04/21/2022",15572,5879018,37241397,14349717,5730079
FL,"04/28/2022",20766,5899784,37444720,14374253,5768622
FL,"05/05/2022",26500,5926284,37616840,14396898,5801846
FL,"05/12/2022",32945,5959229,37768199,14417209,5832296
FL,"05/19/2022",39385,5998614,37929765,14436496,5864535
FL,"05/26/2022",60148,6058762,38101805,14456942,5899995
FL,"06/02/2022",66796,6125558,38232596,14473552,5929372
FL,"06/09/2022",71645,6197203,38359764,14491643,5958389
FL,"06/16/2022",74336,6271539,38470774,14507397,5984354
GA,"12/17/2020",42822,560607,0,0,""
GA,"12/24/2020",47684,608291,24173,0,""
GA,"12/31/2020",46452,654743,75157,0,""
GA,"01/07/2021",59099,713842,103793,0,""
GA,"01/14/2021",68454,782296,231305,0,""
GA,"01/21/2021",54424,836720,453862,0,""
GA,"01/28/2021",48885,885605,764211,0,""
GA,"02/04/2021",36752,922357,1008040,0,""
GA,"02/11/2021",28551,950908,1273015,0,""
GA,"02/18/2021",22342,973250,1569216,0,""
GA,"02/25/2021",20805,994055,1961849,0,""
GA,"03/04/2021",20441,1014496,2187289,0,""
GA,"03/11/2021",13865,1028361,2483900,936451,""
GA,"03/18/2021",10107,1038468,2906563,1082385,""
GA,"03/25/2021",10915,1049383,3434860,1208667,""
GA,"04/01/2021",10168,1059551,3950645,1327557,""
GA,"04/08/2021",8645,1068196,4541621,1536865,""
GA,"04/15/2021",10181,1078377,5157520,1835536,""
GA,"04/22/2021",9415,1087792,5740162,2202939,""
GA,"04/29/2021",9442,1097234,6218010,2527545,""
GA,"05/06/2021",8541,1105775,6552673,2763645,""
GA,"05/13/2021",6388,1112163,6960793,3037554,""
GA,"05/20/2021",5174,1117337,7212497,3183565,""
GA,"05/27/2021",3976,1121313,7410254,3295633,""
GA,"06/03/2021",3098,1124411,7612650,3409346,""
GA,"06/10/2021",2699,1127110,7935079,3590749,""
GA,"06/17/2021",2540,1129650,8097319,3692677,""
GA,"06/24/2021",2299,1131949,8221814,3762566,""
GA,"07/01/2021",2621,1134570,8445684,3893218,""
GA,"07/08/2021",2992,1137562,8549769,3941470,""
GA,"07/15/2021",5965,1143527,8628869,3980303,""
GA,"07/22/2021",9541,1153068,8748307,4037519,""
GA,"07/29/2021",18164,1171232,8904071,4093544,""
GA,"08/05/2021",28397,1199629,9080138,4145869,""
GA,"08/12/2021",38755,1238384,9208320,4183379,""
GA,"08/19/2021",49283,1287667,9436941,4262186,""
GA,"08/26/2021",60354,1348021,9638282,4342677,0
GA,"09/02/2021",65263,1413284,9883793,4445340,0
GA,"09/09/2021",55126,1468410,10114310,4540409,0
GA,"09/16/2021",45260,1513670,10285679,4622898,0
GA,"09/23/2021",35014,1548684,10504413,4737079,0
GA,"09/30/2021",25152,1573836,10673110,4823331,0
GA,"10/07/2021",19844,1593680,10855634,4901526,0
GA,"10/14/2021",18013,1611693,11032372,4973251,0
GA,"10/21/2021",10683,1622376,11112900,5006654,244965
GA,"10/28/2021",8971,1631347,11360060,5091916,351668
GA,"11/04/2021",7258,1638605,11638712,5148931,524044
GA,"11/11/2021",6390,1644995,11796384,5180014,616219
GA,"11/18/2021",6959,1651954,12027136,5216907,742534
GA,"11/25/2021",7526,1659480,12185763,5241785,834898
GA,"12/02/2021",6626,1666106,12428816,5281455,973242
GA,"12/09/2021",9338,1675444,12598737,5284283,1093630
GA,"12/16/2021",10882,1686326,12856591,5337707,1241560
GA,"12/23/2021",27766,1714092,13075011,5377295,1369374
GA,"12/30/2021",77929,1792021,13331712,5423280,1507455
GA,"01/06/2022",136921,1928942,13523352,5458048,1610217
GA,"01/13/2022",81131,2010073,13718189,5495289,1712092
GA,"01/20/2022",113855,2123928,13841416,5563349,1794783
GA,"01/27/2022",182097,2306025,13974241,5597004,1857386
GA,"02/03/2022",80275,2386300,14071822,5626517,1898016
GA,"02/10/2022",38640,2424940,14156833,5654378,1930738
GA,"02/17/2022",21527,2446467,14260032,5665409,1958880
GA,"02/24/2022",12396,2458863,14324212,5684843,1983150
GA,"03/03/2022",8832,2467695,14377862,5700821,2003157
GA,"03/10/2022",5979,2473674,14441599,5720015,2028161
GA,"03/17/2022",5700,2479374,14490924,5734815,2044956
GA,"03/24/2022",4000,2483374,14532099,5746575,2060432
GA,"03/31/2022",12183,2495557,14571162,5757080,2076089
GA,"04/07/2022",5711,2501268,14646656,5770526,2102452
GA,"04/14/2022",3269,2504537,14731330,5782666,2128181
GA,"04/21/2022",4079,2508616,14805598,5793052,2148381
GA,"04/28/2022",6082,2514698,14883970,5805736,2172027
GA,"05/05/2022",6687,2521385,14947190,5815941,2189274
GA,"05/12/2022",9360,2530745,15004890,5825301,2204840
GA,"05/19/2022",10939,2541684,15076586,5835952,2224705
GA,"05/26/2022",14332,2556016,15130296,5843680,2239895
GA,"06/02/2022",15043,2571059,15181534,5851416,2255382
GA,"06/09/2022",17715,2588774,15235731,5860372,2271304
GA,"06/16/2022",19387,2608161,15284156,5868392,2285451
GU,"12/17/2020",129,7168,0,0,""
GU,"12/24/2020",89,7257,1907,0,""
GU,"12/31/2020",51,7308,2118,0,""
GU,"01/07/2021",70,7378,3791,0,""
GU,"01/14/2021",66,7444,3791,0,""
GU,"01/21/2021",77,7521,3791,0,""
GU,"01/28/2021",47,7568,19520,0,""
GU,"02/04/2021",50,7618,26068,0,""
GU,"02/11/2021",55,7673,33993,0,""
GU,"02/18/2021",30,7703,42671,0,""
GU,"02/25/2021",26,7729,52661,0,""
GU,"03/04/2021",16,7745,56131,0,""
GU,"03/11/2021",11,7756,62062,25258,""
GU,"03/18/2021",20,7776,70056,30003,""
GU,"03/25/2021",13,7789,79350,31248,""
GU,"04/01/2021",18,7807,88590,32234,""
GU,"04/08/2021",21,7828,97187,34813,""
GU,"04/15/2021",28,7856,107691,40329,""
GU,"04/22/2021",53,7909,119005,47193,""
GU,"04/29/2021",50,7959,128681,53414,""
GU,"05/06/2021",61,8020,134208,56991,""
GU,"05/13/2021",43,8063,145571,64698,""
GU,"05/20/2021",61,8124,150364,67710,""
GU,"05/27/2021",30,8154,155385,70177,""
GU,"06/03/2021",39,8193,161786,73767,""
GU,"06/10/2021",37,8230,169333,77546,""
GU,"06/17/2021",36,8266,177032,82530,""
GU,"06/24/2021",50,8316,181112,85186,""
GU,"07/01/2021",50,8366,189680,90755,""
GU,"07/08/2021",57,8423,192503,92457,""
GU,"07/15/2021",50,8473,196106,94649,""
GU,"07/22/2021",27,8500,198645,96279,""
GU,"07/29/2021",29,8529,201341,97823,""
GU,"08/05/2021",123,8652,203698,99201,""
GU,"08/12/2021",213,8865,205529,100259,""
GU,"08/19/2021",335,9200,207345,101093,""
GU,"08/26/2021",667,9867,212120,103132,0
GU,"09/02/2021",1042,10909,216899,104550,0
GU,"09/09/2021",910,11819,220116,105653,0
GU,"09/16/2021",1326,13145,225287,107906,0
GU,"09/23/2021",953,14098,229123,110146,0
GU,"09/30/2021",943,15041,234734,113258,0
GU,"10/07/2021",886,15927,238538,115277,0
GU,"10/14/2021",763,16690,243942,117100,0
GU,"10/21/2021",689,17379,247846,118496,5626
GU,"10/28/2021",661,18040,254958,120842,9115
GU,"11/04/2021",467,18507,257304,121410,10518
GU,"11/11/2021",333,18840,261657,122123,13592
GU,"11/18/2021",200,19040,265958,122625,16765
GU,"11/25/2021",106,19146,272325,123273,21079
GU,"12/02/2021",81,19227,276837,123857,23771
GU,"12/09/2021",73,19300,282780,124685,26999
GU,"12/16/2021",57,19357,287654,125736,29649
GU,"12/23/2021",70,19427,291338,126582,31629
GU,"12/30/2021",139,19566,292986,127007,32433
GU,"01/06/2022",785,20351,295361,127519,33677
GU,"01/13/2022",2128,22479,298159,128105,35371
GU,"01/20/2022",3278,25757,304807,129152,39437
GU,"01/27/2022",4464,30221,309865,130323,42133
GU,"02/03/2022",4389,34610,315234,131450,45247
GU,"02/10/2022",4062,38672,320183,132546,47915
GU,"02/17/2022",3108,41780,325017,133741,49498
GU,"02/24/2022",2056,43836,329166,134682,51716
GU,"03/03/2022",1405,45241,333247,135603,53810
GU,"03/10/2022",759,46000,335810,136173,55270
GU,"03/17/2022",650,46650,340048,137299,57332
GU,"03/24/2022",359,47009,342257,137979,58333
GU,"03/31/2022",256,47265,343500,138305,59036
GU,"04/07/2022",249,47514,344395,138518,59447
GU,"04/14/2022",168,47682,345795,138743,60033
GU,"04/21/2022",220,47902,347238,138974,60385
GU,"04/28/2022",211,48113,348862,139143,60845
GU,"05/05/2022",189,48302,350280,139361,61200
GU,"05/12/2022",167,48469,353335,139697,61907
GU,"05/19/2022",197,48666,354980,139882,62355
GU,"05/26/2022",241,48907,356132,140022,62651
GU,"06/02/2022",355,49262,357251,140138,62952
GU,"06/09/2022",517,49779,359069,140392,63701
GU,"06/16/2022",706,50485,361088,140593,64469
HI,"12/17/2020",856,19927,1853,0,""
HI,"12/24/2020",897,20824,12826,0,""
HI,"12/31/2020",687,21511,24992,0,""
HI,"01/07/2021",1131,22642,33234,0,""
HI,"01/14/2021",1362,24004,5001,0,""
HI,"01/21/2021",889,24893,79414,0,""
HI,"01/28/2021",817,25710,103944,0,""
HI,"02/04/2021",613,26323,151107,0,""
HI,"02/11/2021",483,26806,200618,0,""
HI,"02/18/2021",327,27133,247392,0,""
HI,"02/25/2021",346,27479,348897,0,""
HI,"03/04/2021",317,27796,411264,0,""
HI,"03/11/2021",406,28202,489283,188723,""
HI,"03/18/2021",455,28657,572716,219607,""
HI,"03/25/2021",646,29303,642642,242800,""
HI,"04/01/2021",827,30130,717790,276272,""
HI,"04/08/2021",703,30833,798942,322180,""
HI,"04/15/2021",662,31495,895171,379371,""
HI,"04/22/2021",637,32132,1104900,451914,""
HI,"04/29/2021",604,32736,1209189,496734,""
HI,"05/06/2021",739,33475,1264550,524415,""
HI,"05/13/2021",622,34097,1413166,592676,""
HI,"05/20/2021",601,34698,1511715,640679,""
HI,"05/27/2021",375,35073,1565795,667016,""
HI,"06/03/2021",375,35448,1595283,677530,""
HI,"06/10/2021",372,35820,1620631,691802,""
HI,"06/17/2021",393,36213,1649657,712370,""
HI,"06/24/2021",309,36522,1668004,725008,""
HI,"07/01/2021",326,36848,1680216,733872,""
HI,"07/08/2021",378,37226,1691137,741187,""
HI,"07/15/2021",590,37816,1700838,747409,""
HI,"07/22/2021",995,38811,1706014,752060,""
HI,"07/29/2021",1587,40398,1715831,756640,""
HI,"08/05/2021",2820,43218,1725776,760933,""
HI,"08/12/2021",4032,47250,1737962,765742,""
HI,"08/19/2021",4815,52065,1752421,771347,""
HI,"08/26/2021",5544,57609,1767916,776863,0
HI,"09/02/2021",5897,63506,1787222,784039,0
HI,"09/09/2021",4903,68409,1812251,793060,0
HI,"09/16/2021",4165,72574,1835332,802608,0
HI,"09/23/2021",3349,75923,1852930,810879,0
HI,"09/30/2021",2432,78355,1875555,819498,0
HI,"10/07/2021",1741,80096,1902836,827347,0
HI,"10/14/2021",1148,81244,1924619,833274,0
HI,"10/21/2021",911,82155,1948246,839645,55143
HI,"10/28/2021",980,83135,1969150,844740,67368
HI,"11/04/2021",758,83893,1993460,849052,82523
HI,"11/11/2021",785,84678,2020262,853449,95164
HI,"11/18/2021",689,85367,2046792,856956,107161
HI,"11/25/2021",673,86040,2070008,859993,117568
HI,"12/02/2021",600,86640,2095181,867081,127562
HI,"12/09/2021",728,87368,2128223,878079,140352
HI,"12/16/2021",1565,88933,2151776,885913,149693
HI,"12/23/2021",5797,94730,2202894,894261,157428
HI,"12/30/2021",12308,107038,2244695,900918,162981
HI,"01/06/2022",20135,127173,2280397,906741,167742
HI,"01/13/2022",32226,159399,2636108,1054993,433837
HI,"01/20/2022",29495,188894,2660175,1067458,463038
HI,"01/27/2022",22197,211091,2694859,1071963,486492
HI,"02/03/2022",12690,223781,2725469,1077114,505944
HI,"02/10/2022",6725,230506,2751155,1082655,520453
HI,"02/17/2022",3388,233894,2785446,1088154,530755
HI,"02/24/2022",1927,235821,2798201,1091528,537275
HI,"03/03/2022",1284,237105,2809837,1094684,542711
HI,"03/10/2022",948,238053,2819420,1097154,546410
HI,"03/17/2022",713,238766,2826979,1098786,549856
HI,"03/24/2022",815,239581,2833712,1100143,553043
HI,"03/31/2022",956,240537,2838807,1101128,555558
HI,"04/07/2022",1144,241681,2849844,1102474,557557
HI,"04/14/2022",1447,243128,2872921,1104412,560697
HI,"04/21/2022",2178,245306,2890983,1106043,563034
HI,"04/28/2022",3056,248362,2907844,1107310,565238
HI,"05/05/2022",4344,252706,2927595,1108717,569239
HI,"05/12/2022",6133,258839,2942667,1109895,571694
HI,"05/19/2022",7405,266244,2957098,1111079,574027
HI,"05/26/2022",8813,275057,2974881,1112404,577069
HI,"06/02/2022",8645,283702,2988244,1113359,580034
HI,"06/09/2022",8207,291909,3009640,1115231,585476
HI,"06/16/2022",6842,298751,3021612,1116139,588316
IA,"12/17/2020",10494,260774,1693,0,""
IA,"12/24/2020",11338,272112,21341,0,""
IA,"12/31/2020",7952,280064,45589,0,""
IA,"01/07/2021",10713,290777,74224,0,""
IA,"01/14/2021",10384,301161,120983,0,""
IA,"01/21/2021",7627,308788,158743,0,""
IA,"01/28/2021",7326,316114,212497,0,""
IA,"02/04/2021",6194,322308,279252,0,""
IA,"02/11/2021",4753,327061,387370,0,""
IA,"02/18/2021",3846,330907,507650,0,""
IA,"02/25/2021",3758,334665,631160,0,""
IA,"03/04/2021",3497,338162,773314,0,""
IA,"03/11/2021",3219,341381,999390,339509,""
IA,"03/18/2021",2889,344270,1182560,441682,""
IA,"03/25/2021",3323,347593,1369302,530038,""
IA,"04/01/2021",3811,351404,1567904,621545,""
IA,"04/08/2021",3798,355202,1765354,712554,""
IA,"04/15/2021",3187,358389,2001742,838544,""
IA,"04/22/2021",3329,361718,2176895,936258,""
IA,"04/29/2021",2579,364297,2351211,1046172,""
IA,"05/06/2021",2420,366717,2495695,1153092,""
IA,"05/13/2021",1993,368710,2612715,1241247,""
IA,"05/20/2021",1344,370054,2717558,1310692,""
IA,"05/27/2021",973,371027,2808476,1360138,""
IA,"06/03/2021",587,371614,2858476,1390163,""
IA,"06/10/2021",573,372187,2914925,1427923,""
IA,"06/17/2021",574,372761,2963998,1464586,""
IA,"06/24/2021",457,373218,3004010,1491517,""
IA,"07/01/2021",514,373732,3039341,1515827,""
IA,"07/08/2021",651,374383,3061232,1529887,""
IA,"07/15/2021",895,375278,3083142,1541212,""
IA,"07/22/2021",1395,376673,3106922,1552448,""
IA,"07/29/2021",2158,378831,3132842,1562631,""
IA,"08/05/2021",3570,382401,3163613,1574118,""
IA,"08/12/2021",4872,387273,3196044,1584976,""
IA,"08/19/2021",5697,392970,3235353,1600378,""
IA,"08/26/2021",7112,400082,3276425,1618205,0
IA,"09/02/2021",8308,408390,3315438,1637139,0
IA,"09/09/2021",8762,417152,3349112,1654065,0
IA,"09/16/2021",11365,428517,3384399,1672372,0
IA,"09/23/2021",12163,440680,3416694,1689691,0
IA,"09/30/2021",10812,451492,3452574,1702842,0
IA,"10/07/2021",9860,461352,3514279,1715447,0
IA,"10/14/2021",8167,469519,3563074,1726571,0
IA,"10/21/2021",6907,476426,3613995,1737500,129752
IA,"10/28/2021",6983,483409,3690242,1748251,185329
IA,"11/04/2021",7643,491052,3796829,1758689,269243
IA,"11/11/2021",8227,499279,3914972,1767867,354571
IA,"11/18/2021",9234,508513,4039408,1776160,430365
IA,"11/25/2021",10346,518859,4130627,1782766,495597
IA,"12/02/2021",9362,528221,4232948,1795954,565683
IA,"12/09/2021",12812,541033,4356654,1819836,646626
IA,"12/16/2021",11865,552898,4461143,1838496,715752
IA,"12/23/2021",9565,562463,4556310,1851080,779843
IA,"12/30/2021",10569,573032,4624085,1860149,824277
IA,"01/06/2022",18996,592028,4679330,1869493,858228
IA,"01/13/2022",34308,626336,4735965,1879386,893153
IA,"01/20/2022",38574,664910,4783551,1892560,922823
IA,"01/27/2022",34949,699859,4820910,1900354,944368
IA,"02/03/2022",22730,722589,4852862,1909011,961030
IA,"02/10/2022",12833,735422,4877323,1914551,973198
IA,"02/17/2022",7863,743285,4901210,1920753,983610
IA,"02/24/2022",4363,747648,4918082,1925828,991506
IA,"03/03/2022",6838,754486,4932514,1930254,998197
IA,"03/10/2022",1738,756224,4944249,1933694,1003576
IA,"03/17/2022",1005,757229,4954495,1936826,1008197
IA,"03/24/2022",716,757945,4963635,1939278,1012639
IA,"03/31/2022",470,758415,4974109,1941797,1017772
IA,"04/07/2022",921,759336,5005526,1944823,1022271
IA,"04/14/2022",891,760227,5037237,1947602,1026262
IA,"04/21/2022",1098,761325,5070677,1950507,1030245
IA,"04/28/2022",1728,763053,5101035,1953232,1034239
IA,"05/05/2022",2124,765177,5128472,1955644,1037887
IA,"05/12/2022",3161,768338,5151232,1957931,1041123
IA,"05/19/2022",3843,772181,5174290,1960008,1044416
IA,"05/26/2022",3955,776136,5198496,1962123,1048291
IA,"06/02/2022",3857,779993,5216469,1963744,1051592
IA,"06/09/2022",4276,784269,5234849,1965565,1055534
IA,"06/16/2022",3996,788265,5251360,1967207,1059134
ID,"12/17/2020",9249,125452,0,0,""
ID,"12/24/2020",8533,133985,0,0,""
ID,"12/31/2020",5880,139865,13614,0,""
ID,"01/07/2021",6245,146110,22822,0,""
ID,"01/14/2021",6255,152365,42586,0,""
ID,"01/21/2021",5223,157588,73372,0,""
ID,"01/28/2021",3624,161212,102800,0,""
ID,"02/04/2021",2951,164163,141897,0,""
ID,"02/11/2021",2390,166553,214063,0,""
ID,"02/18/2021",1801,168354,278474,0,""
ID,"02/25/2021",1938,170292,356987,0,""
ID,"03/04/2021",1996,172288,428196,0,""
ID,"03/11/2021",1957,174245,507965,187365,""
ID,"03/18/2021",2216,176461,586497,224667,""
ID,"03/25/2021",2084,178545,678747,262073,""
ID,"04/01/2021",1993,180538,766703,300140,""
ID,"04/08/2021",1993,182531,855028,343296,""
ID,"04/15/2021",1817,184348,929172,385531,""
ID,"04/22/2021",1410,185758,1004155,433065,""
ID,"04/29/2021",1509,187267,1066942,475681,""
ID,"05/06/2021",1167,188434,1116681,508582,""
ID,"05/13/2021",1152,189586,1160043,538266,""
ID,"05/20/2021",1125,190711,1193617,560127,""
ID,"05/27/2021",1025,191736,1223895,577568,""
ID,"06/03/2021",743,192479,1243355,589073,""
ID,"06/10/2021",813,193292,1265340,602843,""
ID,"06/17/2021",626,193918,1292554,623791,""
ID,"06/24/2021",600,194518,1306006,632531,""
ID,"07/01/2021",478,194996,1325701,645372,""
ID,"07/08/2021",555,195551,1337388,651402,""
ID,"07/15/2021",939,196490,1348106,657334,""
ID,"07/22/2021",1290,197780,1357254,661753,""
ID,"07/29/2021",1736,199516,1369189,666444,""
ID,"08/05/2021",3153,202669,1383514,671709,""
ID,"08/12/2021",3854,206523,1397994,676878,""
ID,"08/19/2021",5010,211533,1418000,684003,""
ID,"08/26/2021",4528,216061,1444106,694229,0
ID,"09/02/2021",6491,222552,1466935,703071,0
ID,"09/09/2021",7045,229597,1487910,711575,0
ID,"09/16/2021",8718,238315,1514700,723255,0
ID,"09/23/2021",8434,246749,1538904,734326,0
ID,"09/30/2021",8668,255417,1565695,743735,0
ID,"10/07/2021",9245,264662,1601939,753593,0
ID,"10/14/2021",7963,272625,1630094,761719,0
ID,"10/21/2021",8845,281470,1659029,770320,65816
ID,"10/28/2021",7453,288923,1699050,780855,88830
ID,"11/04/2021",5562,294485,1747860,788073,122751
ID,"11/11/2021",4149,298634,1792497,795014,153755
ID,"11/18/2021",3209,301843,1825208,800023,176516
ID,"11/25/2021",3287,305130,1860658,805110,201254
ID,"12/02/2021",2432,307562,1895988,810070,225763
ID,"12/09/2021",3099,310661,1939118,815372,256643
ID,"12/16/2021",2380,313041,1974316,819986,281754
ID,"12/23/2021",2229,315270,2007688,824055,305096
ID,"12/30/2021",3188,318458,2022021,826087,314456
ID,"01/06/2022",5507,323965,2040976,828885,326549
ID,"01/13/2022",10121,334086,2063086,832359,340650
ID,"01/20/2022",14863,348949,2108977,850304,354788
ID,"01/27/2022",19716,368665,2304792,930708,364707
ID,"02/03/2022",16076,384741,2321666,935189,372002
ID,"02/10/2022",13127,397868,2334941,939111,377646
ID,"02/17/2022",11263,409131,2347496,944030,381847
ID,"02/24/2022",10037,419168,2360131,947620,385406
ID,"03/03/2022",10305,429473,2369918,950457,388623
ID,"03/10/2022",6546,436019,2377374,952719,391069
ID,"03/17/2022",4721,440740,2383661,954809,393133
ID,"03/24/2022",2534,443274,2389645,956589,395234
ID,"03/31/2022",639,443913,2395288,958184,397202
ID,"04/07/2022",612,444525,2408284,960032,399620
ID,"04/14/2022",382,444907,2422490,961810,401987
ID,"04/21/2022",441,445348,2436736,963979,404380
ID,"04/28/2022",472,445820,2447710,965384,406325
ID,"05/05/2022",728,446548,2457740,966710,408190
ID,"05/12/2022",992,447540,2485842,975628,409978
ID,"05/19/2022",1214,448754,2511189,991015,411819
ID,"05/26/2022",1583,450337,2536104,993164,426558
ID,"06/02/2022",1748,452085,2544159,994237,428451
ID,"06/09/2022",2492,454577,2553067,995323,430602
ID,"06/16/2022",2449,457026,2561404,996428,432595
IL,"12/17/2020",58170,870601,0,0,""
IL,"12/24/2020",47465,918066,80089,0,""
IL,"12/31/2020",37315,955381,148860,0,""
IL,"01/07/2021",43907,999288,235686,0,""
IL,"01/14/2021",46742,1046030,437269,0,""
IL,"01/21/2021",35330,1081360,570527,0,""
IL,"01/28/2021",30826,1112186,823325,0,""
IL,"02/04/2021",22045,1134231,1178369,0,""
IL,"02/11/2021",18764,1152995,1604830,0,""
IL,"02/18/2021",13718,1166713,2037388,0,""
IL,"02/25/2021",12630,1179343,2519447,0,""
IL,"03/04/2021",12175,1191518,3107699,0,""
IL,"03/11/2021",11191,1202709,3777731,1245707,""
IL,"03/18/2021",11057,1213766,4584510,1637747,""
IL,"03/25/2021",13938,1227704,5287852,1872114,""
IL,"04/01/2021",16883,1244587,6073419,2140575,""
IL,"04/08/2021",20872,1265459,6860904,2469095,""
IL,"04/15/2021",23476,1288935,7723702,2948062,""
IL,"04/22/2021",20617,1309552,8606345,3403952,""
IL,"04/29/2021",18903,1328455,9335649,3790076,""
IL,"05/06/2021",17941,1346396,9859955,4097876,""
IL,"05/13/2021",13351,1359747,10434159,4472084,""
IL,"05/20/2021",10591,1370338,10947955,4750034,""
IL,"05/27/2021",8054,1378392,11454543,4978526,""
IL,"06/03/2021",4664,1383056,11748935,5113364,""
IL,"06/10/2021",3196,1386252,12077496,5290097,""
IL,"06/17/2021",2059,1388311,12457407,5538524,""
IL,"06/24/2021",1571,1389882,12680771,5663008,""
IL,"07/01/2021",1861,1391743,13002032,5865479,""
IL,"07/08/2021",2497,1394240,13130458,5931888,""
IL,"07/15/2021",4173,1398413,13290265,6010374,""
IL,"07/22/2021",6056,1404469,13433726,6073610,""
IL,"07/29/2021",11104,1415573,13563669,6123702,""
IL,"08/05/2021",14692,1430265,13765464,6194696,""
IL,"08/12/2021",20829,1451094,13936712,6255348,""
IL,"08/19/2021",23191,1474285,14231724,6344469,""
IL,"08/26/2021",24737,1499022,14410870,6423656,0
IL,"09/02/2021",29098,1528120,14698120,6512907,0
IL,"09/09/2021",26216,1554336,14838317,6570286,0
IL,"09/16/2021",28056,1582392,15007332,6646904,0
IL,"09/23/2021",22928,1605320,15149254,6715405,0
IL,"09/30/2021",18844,1624164,15320266,6780671,0
IL,"10/07/2021",19829,1643993,15539702,6840978,0
IL,"10/14/2021",16891,1660884,15696131,6886348,0
IL,"10/21/2021",14910,1675794,15701304,6889496,266408
IL,"10/28/2021",14479,1690273,15705319,6898819,271767
IL,"11/04/2021",15509,1705782,16434312,7690351,934971
IL,"11/11/2021",21852,1727634,16870913,7755904,1210795
IL,"11/18/2021",24868,1752502,16983006,7700203,1457539
IL,"11/25/2021",32398,1784900,17604565,7776092,1716812
IL,"12/02/2021",31094,1815994,17941198,7805286,1967662
IL,"12/09/2021",51918,1867912,18514016,7942254,2281814
IL,"12/16/2021",53522,1921434,18974384,8025343,2583317
IL,"12/23/2021",80926,2002360,19467073,8091967,2905263
IL,"12/30/2021",116802,2119162,19742882,8114639,3110345
IL,"01/06/2022",176283,2295445,20156464,8193461,3311210
IL,"01/13/2022",227508,2522953,20538619,8249223,3529186
IL,"01/20/2022",186521,2709474,20863825,8310950,3724378
IL,"01/27/2022",157825,2867299,21132051,8357859,3883514
IL,"02/03/2022",71800,2939099,21402535,8428885,4019036
IL,"02/10/2022",42977,2982076,21503681,8461913,4070577
IL,"02/17/2022",25845,3007921,21627616,8499176,4132976
IL,"02/24/2022",14656,3022577,21736793,8535116,4176295
IL,"03/03/2022",12054,3034631,21829107,8566628,4217018
IL,"03/10/2022",7814,3042445,21906684,8597474,4251180
IL,"03/17/2022",8124,3050569,21961680,8614072,4280105
IL,"03/24/2022",7560,3058129,22022005,8633065,4312133
IL,"03/31/2022",8454,3066583,22070985,8646386,4339117
IL,"04/07/2022",9991,3076574,22201667,8664361,4368841
IL,"04/14/2022",12108,3088682,22347239,8681595,4396270
IL,"04/21/2022",17927,3106609,22433149,8685693,4415974
IL,"04/28/2022",21527,3128136,22583411,8708021,4447651
IL,"05/05/2022",29317,3157453,22705514,8724048,4477035
IL,"05/12/2022",37793,3195246,22886032,8760011,4533764
IL,"05/19/2022",42043,3237289,22996086,8775567,4563263
IL,"05/26/2022",37068,3274357,22998234,8751145,4584714
IL,"06/02/2022",32406,3306763,23122078,8769351,4611777
IL,"06/09/2022",35779,3342542,23115699,8743414,4621091
IL,"06/16/2022",28720,3371262,23201025,8754366,4645258
IN,"12/17/2020",42433,440850,686,0,""
IN,"12/24/2020",35688,476538,33635,0,""
IN,"12/31/2020",28482,505020,74351,0,""
IN,"01/07/2021",34209,539229,137212,0,""
IN,"01/14/2021",34890,574119,258457,0,""
IN,"01/21/2021",24194,598313,387137,0,""
IN,"01/28/2021",18863,617176,552144,0,""
IN,"02/04/2021",14157,631333,671191,0,""
IN,"02/11/2021",11972,643305,832031,0,""
IN,"02/18/2021",8148,651453,1125976,0,""
IN,"02/25/2021",6592,658045,1459296,0,""
IN,"03/04/2021",5466,663511,1697536,0,""
IN,"03/11/2021",5654,669165,1979075,765301,""
IN,"03/18/2021",5269,674434,2252443,893151,""
IN,"03/25/2021",5607,680041,2540707,1011271,""
IN,"04/01/2021",6452,686493,2840511,1147247,""
IN,"04/08/2021",6960,693453,3158259,1298097,""
IN,"04/15/2021",8519,701972,3509410,1449816,""
IN,"04/22/2021",8639,710611,3811526,1598850,""
IN,"04/29/2021",6952,717563,4089471,1767251,""
IN,"05/06/2021",7796,725359,4360742,1940977,""
IN,"05/13/2021",6451,731810,4621947,2106606,""
IN,"05/20/2021",5472,737282,4844506,2240373,""
IN,"05/27/2021",4417,741699,5028975,2342184,""
IN,"06/03/2021",2780,744479,5141173,2405517,""
IN,"06/10/2021",3323,747802,5244854,2468780,""
IN,"06/17/2021",2366,750168,5427988,2594530,""
IN,"06/24/2021",1942,752110,5513454,2643394,""
IN,"07/01/2021",1818,753928,5600334,2693550,""
IN,"07/08/2021",2150,756078,5867459,2883877,""
IN,"07/15/2021",2983,759061,5924769,2915266,""
IN,"07/22/2021",3776,762837,5984853,2943569,""
IN,"07/29/2021",5788,768625,6049790,2968638,""
IN,"08/05/2021",8799,777424,6120501,2994681,""
IN,"08/12/2021",13502,790926,6188855,3020153,""
IN,"08/19/2021",18619,809545,6266180,3053349,""
IN,"08/26/2021",24423,833968,6354045,3089614,0
IN,"09/02/2021",28967,862935,6447041,3128226,0
IN,"09/09/2021",26314,889249,6498918,3150899,0
IN,"09/16/2021",29441,918690,6579742,3188114,0
IN,"09/23/2021",23439,942129,6659955,3230161,0
IN,"09/30/2021",18875,961004,6746850,3256806,0
IN,"10/07/2021",17747,978751,6866334,3283336,0
IN,"10/14/2021",15247,993998,6961917,3308024,0
IN,"10/21/2021",12506,1006504,7048145,3328319,237121
IN,"10/28/2021",11288,1017792,7143665,3345526,298801
IN,"11/04/2021",11547,1029339,7308293,3364015,422410
IN,"11/11/2021",14259,1043598,7427755,3376239,504008
IN,"11/18/2021",18193,1061791,7555848,3388095,581949
IN,"11/25/2021",22697,1084488,7716326,3401497,689378
IN,"12/02/2021",22701,1107189,7819045,3414969,757985
IN,"12/09/2021",32962,1140151,8027764,3442983,896891
IN,"12/16/2021",30804,1170955,8230014,3472742,1033233
IN,"12/23/2021",29971,1200926,8422387,3489580,1168220
IN,"12/30/2021",33993,1234919,8511980,3500787,1227674
IN,"01/06/2022",64561,1299480,8589967,3511958,1276569
IN,"01/13/2022",94094,1393574,8740716,3533415,1369113
IN,"01/20/2022",96929,1490503,8885173,3559019,1457827
IN,"01/27/2022",84304,1574807,8974626,3573081,1506282
IN,"02/03/2022",61215,1636022,9048887,3591649,1541313
IN,"02/10/2022",19106,1655128,9090509,3605880,1557964
IN,"02/17/2022",16171,1671299,9144662,3622333,1577931
IN,"02/24/2022",7329,1678628,9181342,3633484,1593175
IN,"03/03/2022",4037,1682665,9215368,3642282,1608391
IN,"03/10/2022",3329,1685994,9243373,3650556,1619856
IN,"03/17/2022",1922,1687916,9269896,3658109,1630832
IN,"03/24/2022",1746,1689662,9293218,3663884,1641169
IN,"03/31/2022",1381,1691043,9315557,3669304,1651015
IN,"04/07/2022",1200,1692243,9369479,3675056,1663277
IN,"04/14/2022",1322,1693565,9423293,3679983,1672960
IN,"04/21/2022",2171,1695736,9470295,3684586,1682054
IN,"04/28/2022",5034,1700770,9510792,3688866,1690487
IN,"05/05/2022",4615,1705385,9549046,3693218,1698456
IN,"05/12/2022",5888,1711273,9584378,3697372,1706034
IN,"05/19/2022",7222,1718495,9618812,3701189,1713371
IN,"05/26/2022",9323,1727818,9723216,3716190,1724117
IN,"06/02/2022",7753,1735571,9748016,3719174,1730021
IN,"06/09/2022",9549,1745120,9776752,3723463,1736962
IN,"06/16/2022",7986,1753106,10037673,3791496,1804406
KS,"12/17/2020",15020,196503,187,0,""
KS,"12/24/2020",15120,211623,8822,0,""
KS,"12/31/2020",12451,224074,13708,0,""
KS,"01/07/2021",14134,238208,36538,0,""
KS,"01/14/2021",14986,253194,97586,0,""
KS,"01/21/2021",11344,264538,130434,0,""
KS,"01/28/2021",9281,273819,190301,0,""
KS,"02/04/2021",6468,280287,251425,0,""
KS,"02/11/2021",5936,286223,332923,0,""
KS,"02/18/2021",3828,290051,417825,0,""
KS,"02/25/2021",4088,294139,542433,0,""
KS,"03/04/2021",2248,296387,661143,0,""
KS,"03/11/2021",2074,298461,796242,284796,""
KS,"03/18/2021",1542,300003,959395,348321,""
KS,"03/25/2021",1425,301428,1140488,420310,""
KS,"04/01/2021",1407,302835,1311354,499609,""
KS,"04/08/2021",1388,304223,1523795,593710,""
KS,"04/15/2021",1539,305762,1720398,709852,""
KS,"04/22/2021",1487,307249,1879973,814109,""
KS,"04/29/2021",1604,308853,1997118,902408,""
KS,"05/06/2021",1546,310399,2085350,970096,""
KS,"05/13/2021",1249,311648,2179220,1040979,""
KS,"05/20/2021",1213,312861,2235270,1073596,""
KS,"05/27/2021",1124,313985,2298485,1104499,""
KS,"06/03/2021",849,314834,2331271,1122149,""
KS,"06/10/2021",924,315758,2375442,1148616,""
KS,"06/17/2021",804,316562,2422300,1181375,""
KS,"06/24/2021",784,317346,2451806,1199784,""
KS,"07/01/2021",1052,318398,2491712,1224715,""
KS,"07/08/2021",1451,319849,2513402,1236052,""
KS,"07/15/2021",1582,321431,2536338,1247097,""
KS,"07/22/2021",2946,324377,2564414,1259549,""
KS,"07/29/2021",4778,329155,2689117,1312724,""
KS,"08/05/2021",4346,333501,2731344,1326778,""
KS,"08/12/2021",11780,345281,2772910,1342688,""
KS,"08/19/2021",7434,352715,2821944,1363126,""
KS,"08/26/2021",9951,362666,2875746,1388653,0
KS,"09/02/2021",10807,373473,2928561,1413349,0
KS,"09/09/2021",9696,383169,2967624,1431569,0
KS,"09/16/2021",10804,393973,3010212,1453230,0
KS,"09/23/2021",8253,402226,3045775,1472376,0
KS,"09/30/2021",6919,409145,3085006,1490136,0
KS,"10/07/2021",6536,415681,3138093,1504832,0
KS,"10/14/2021",5966,421647,3196497,1520222,0
KS,"10/21/2021",5519,427166,3243579,1531735,94675
KS,"10/28/2021",5850,433016,3304696,1545017,128412
KS,"11/04/2021",5433,438449,3383442,1555774,177916
KS,"11/11/2021",6820,445269,3470692,1566749,230487
KS,"11/18/2021",7820,453089,3562507,1575790,276825
KS,"11/25/2021",8271,461360,3644839,1584917,326167
KS,"12/02/2021",8693,470053,3728475,1598588,372165
KS,"12/09/2021",12422,482475,3816744,1617383,420825
KS,"12/16/2021",11153,493628,3910890,1636475,473584
KS,"12/23/2021",12146,505774,3991871,1650286,520132
KS,"12/30/2021",14113,519887,4073766,1661170,554996
KS,"01/06/2022",30068,549955,4129621,1670135,584493
KS,"01/13/2022",31867,581822,4194141,1681521,619022
KS,"01/20/2022",79148,660970,4254401,1705942,650768
KS,"01/27/2022",49072,710042,4299568,1715598,672618
KS,"02/03/2022",28962,739004,4337322,1726225,689466
KS,"02/10/2022",10071,749075,4362480,1733958,700051
KS,"02/17/2022",11679,760754,4408192,1743177,710371
KS,"02/24/2022",3509,764263,4426448,1748742,717667
KS,"03/03/2022",2593,766856,4447211,1755560,724300
KS,"03/10/2022",1361,768217,4470240,1763080,733465
KS,"03/17/2022",821,769038,4480360,1766204,737361
KS,"03/24/2022",532,769570,4491408,1769151,741956
KS,"03/31/2022",492,770062,4500522,1771520,745609
KS,"04/07/2022",242,770304,4518084,1774765,749110
KS,"04/14/2022",948,771252,4547360,1779732,753952
KS,"04/21/2022",1274,772526,4572297,1783905,757911
KS,"04/28/2022",1408,773934,4595462,1787573,761805
KS,"05/05/2022",1585,775519,4618862,1791072,765889
KS,"05/12/2022",1877,777396,4638623,1794903,769385
KS,"05/19/2022",5466,782862,4660146,1798272,773246
KS,"05/26/2022",3133,785995,4679686,1801255,777338
KS,"06/02/2022",3217,789212,4695359,1803625,781073
KS,"06/09/2022",4666,793878,4638559,1818096,807662
KS,"06/16/2022",3985,797863,4654230,1820270,811421
KY,"12/17/2020",21519,230654,1504,0,""
KY,"12/24/2020",19402,250056,19976,0,""
KY,"12/31/2020",14773,264829,52296,0,""
KY,"01/07/2021",32221,297050,94440,0,""
KY,"01/14/2021",25778,322828,174748,0,""
KY,"01/21/2021",21298,344126,235143,0,""
KY,"01/28/2021",18395,362521,342200,0,""
KY,"02/04/2021",15664,378185,455783,0,""
KY,"02/11/2021",12832,391017,608198,0,""
KY,"02/18/2021",7679,398696,726168,0,""
KY,"02/25/2021",8078,406774,907836,0,""
KY,"03/04/2021",5757,412531,1117369,0,""
KY,"03/11/2021",4758,417289,1357068,467334,""
KY,"03/18/2021",4052,421341,1619517,571138,""
KY,"03/25/2021",3899,425240,1876610,661734,""
KY,"04/01/2021",3670,428910,2142945,798150,""
KY,"04/08/2021",3362,432272,2414960,953326,""
KY,"04/15/2021",4185,436457,2704303,1141656,""
KY,"04/22/2021",3680,440137,2934874,1284621,""
KY,"04/29/2021",3585,443722,3110315,1400209,""
KY,"05/06/2021",3694,447416,3240967,1487289,""
KY,"05/13/2021",3058,450474,3374208,1580321,""
KY,"05/20/2021",2613,453087,3484624,1642449,""
KY,"05/27/2021",2094,455181,3603240,1694560,""
KY,"06/03/2021",1458,456639,3670108,1728826,""
KY,"06/10/2021",1486,458125,3751031,1776089,""
KY,"06/17/2021",1254,459379,3866548,1857257,""
KY,"06/24/2021",1081,460460,3932696,1899172,""
KY,"07/01/2021",1165,461625,4002943,1947461,""
KY,"07/08/2021",1418,463043,4041480,1970136,""
KY,"07/15/2021",2826,465869,4082111,1991718,""
KY,"07/22/2021",4672,470541,4122754,2010070,""
KY,"07/29/2021",7885,478426,4175693,2029189,""
KY,"08/05/2021",12258,490684,4244750,2053066,""
KY,"08/12/2021",17539,508223,4312359,2074806,""
KY,"08/19/2021",23725,531948,4391812,2103854,""
KY,"08/26/2021",29569,561517,4484205,2139922,0
KY,"09/02/2021",33192,594709,4585627,2180536,0
KY,"09/09/2021",30529,625238,4668584,2214908,0
KY,"09/16/2021",31240,656478,4757563,2255583,0
KY,"09/23/2021",25826,682304,4840983,2298503,0
KY,"09/30/2021",19195,701499,4930548,2337940,0
KY,"10/07/2021",16244,717743,5031807,2370563,0
KY,"10/14/2021",12329,730072,5124173,2399887,0
KY,"10/21/2021",8911,738983,5196008,2422952,174297
KY,"10/28/2021",7686,746669,5282155,2441766,225482
KY,"11/04/2021",7139,753808,4969707,2274966,301784
KY,"11/11/2021",8518,762326,5094943,2290286,385524
KY,"11/18/2021",9650,771976,5232884,2305717,460229
KY,"11/25/2021",11619,783595,5346850,2318846,530146
KY,"12/02/2021",12729,796324,5454693,2337202,595072
KY,"12/09/2021",16345,812669,5595642,2369477,677108
KY,"12/16/2021",15375,828044,5710932,2394836,744939
KY,"12/23/2021",16777,844821,5816551,2410786,811039
KY,"12/30/2021",27656,872477,5888090,2422138,854257
KY,"01/06/2022",56181,928658,5963769,2434650,898247
KY,"01/13/2022",72901,1001559,6040841,2446657,942783
KY,"01/20/2022",95189,1096748,6114443,2470310,985575
KY,"01/27/2022",86857,1183605,6168457,2481293,1015290
KY,"02/03/2022",61239,1244844,6212423,2492022,1037554
KY,"02/10/2022",42173,1287017,6240009,2500818,1049398
KY,"02/17/2022",13241,1300258,6282042,2511245,1062440
KY,"02/24/2022",13287,1313545,6307433,2518865,1073371
KY,"03/03/2022",7169,1320714,6321157,2523023,1079146
KY,"03/10/2022",4264,1324978,6347335,2530690,1090406
KY,"03/17/2022",3029,1328007,6367748,2537387,1098399
KY,"03/24/2022",1855,1329862,6381151,2541159,1104250
KY,"03/31/2022",1409,1331271,6398743,2546322,1110710
KY,"04/07/2022",1340,1332611,6424014,2550503,1116480
KY,"04/14/2022",1578,1334189,6457435,2554859,1122479
KY,"04/21/2022",2091,1336280,6487841,2558685,1127484
KY,"04/28/2022",431,1336711,6513793,2561976,1132145
KY,"05/05/2022",3936,1340647,6536500,2565020,1136193
KY,"05/12/2022",5654,1346301,6557558,2567956,1140302
KY,"05/19/2022",7218,1353519,6581654,2570805,1144691
KY,"05/26/2022",8669,1362188,6607582,2573773,1149767
KY,"06/02/2022",7685,1369873,6628595,2576300,1154207
KY,"06/09/2022",10053,1379926,6648602,2579158,1158777
KY,"06/16/2022",9102,1389028,6667217,2581476,1163072
LA,"12/17/2020",16625,275551,0,0,""
LA,"12/24/2020",18379,293930,26971,0,""
LA,"12/31/2020",17300,311230,44351,0,""
LA,"01/07/2021",22283,333513,78608,0,""
LA,"01/14/2021",22328,355841,197967,0,""
LA,"01/21/2021",18744,374585,279398,0,""
LA,"01/28/2021",17829,392414,375895,0,""
LA,"02/04/2021",13826,406240,509982,0,""
LA,"02/11/2021",8483,414723,639019,0,""
LA,"02/18/2021",6300,421023,795511,0,""
LA,"02/25/2021",5907,426930,943419,0,""
LA,"03/04/2021",4864,431794,1139071,0,""
LA,"03/11/2021",3711,435505,1340630,487828,""
LA,"03/18/2021",3478,438983,1519659,563914,""
LA,"03/25/2021",3248,442231,1756494,655710,""
LA,"04/01/2021",2643,444874,2003199,780225,""
LA,"04/08/2021",2771,447645,2199349,893502,""
LA,"04/15/2021",3049,450694,2394289,1017907,""
LA,"04/22/2021",3702,454396,2567548,1139692,""
LA,"04/29/2021",2955,457351,2708187,1237218,""
LA,"05/06/2021",3451,460802,2812519,1303293,""
LA,"05/13/2021",3203,464005,2900359,1356658,""
LA,"05/20/2021",3051,467056,2972438,1394985,""
LA,"05/27/2021",2786,469842,3048106,1432609,""
LA,"06/03/2021",2411,472253,3103075,1462006,""
LA,"06/10/2021",2421,474674,3168577,1498902,""
LA,"06/17/2021",2130,476804,3247015,1552326,""
LA,"06/24/2021",2139,478943,3295157,1580796,""
LA,"07/01/2021",2529,481472,3380221,1627321,""
LA,"07/08/2021",4333,485805,3425960,1652871,""
LA,"07/15/2021",7036,492841,3467349,1672304,""
LA,"07/22/2021",14041,506882,3521380,1690044,""
LA,"07/29/2021",25070,531952,3609644,1708955,""
LA,"08/05/2021",30368,562320,3698963,1727264,""
LA,"08/12/2021",39621,601941,3836597,1761790,""
LA,"08/19/2021",36502,638443,3981091,1819137,""
LA,"08/26/2021",32794,671237,4123761,1888430,0
LA,"09/02/2021",20939,692176,4209058,1934964,0
LA,"09/09/2021",13322,705498,4299113,1987192,0
LA,"09/16/2021",16297,721795,4377171,2036277,0
LA,"09/23/2021",10210,732005,4450410,2081367,0
LA,"09/30/2021",7656,739661,4518953,2111741,0
LA,"10/07/2021",5910,745571,4609137,2137185,0
LA,"10/14/2021",4902,750473,4690800,2160565,0
LA,"10/21/2021",3554,754027,4757889,2181564,165264
LA,"10/28/2021",3712,757739,4831989,2208860,207356
LA,"11/04/2021",2952,760691,4914606,2223745,260902
LA,"11/11/2021",2937,763628,4996847,2238237,313418
LA,"11/18/2021",2763,766391,5081041,2250994,364567
LA,"11/25/2021",2660,769051,5162105,2262153,415284
LA,"12/02/2021",2786,771837,5255044,2278316,468200
LA,"12/09/2021",3076,774913,5360696,2294275,537132
LA,"12/16/2021",3629,778542,5460697,2311199,602085
LA,"12/23/2021",8996,787538,5556360,2325646,664013
LA,"12/30/2021",28690,816228,5633478,2336561,711922
LA,"01/06/2022",63321,879549,5713570,2349285,758894
LA,"01/13/2022",70392,949941,5794562,2362987,806220
LA,"01/20/2022",87308,1037249,5857055,2388043,841508
LA,"01/27/2022",107955,1145204,5903012,2399954,864602
LA,"02/03/2022",34568,1179772,5945420,2412396,883962
LA,"02/10/2022",24872,1204644,5987429,2424529,901822
LA,"02/17/2022",11701,1216345,6025656,2433615,912396
LA,"02/24/2022",7638,1223983,6037879,2437569,917993
LA,"03/03/2022",3078,1227061,6064173,2445752,928988
LA,"03/10/2022",2231,1229292,6089784,2453890,937704
LA,"03/17/2022",1272,1230564,6113102,2462260,946430
LA,"03/24/2022",947,1231511,6132103,2468349,953671
LA,"03/31/2022",701,1232212,6144459,2472079,958773
LA,"04/07/2022",968,1233180,6166697,2475882,964299
LA,"04/14/2022",921,1234101,6188554,2478808,968968
LA,"04/21/2022",1537,1235638,6210712,2481745,973762
LA,"04/28/2022",1638,1237276,6233158,2484925,978539
LA,"05/05/2022",2148,1239424,6252446,2487578,982694
LA,"05/12/2022",3340,1242764,6269644,2489913,986054
LA,"05/19/2022",5114,1247878,6292495,2492624,990612
LA,"05/26/2022",6717,1254595,6321859,2495725,996784
LA,"06/02/2022",7191,1261786,6337844,2497754,1000402
LA,"06/09/2022",9226,1271012,6358128,2500554,1004910
LA,"06/16/2022",9943,1280955,6376317,2503099,1009060
MA,"12/17/2020",34700,304112,69,0,""
MA,"12/24/2020",31876,335988,35844,0,""
MA,"12/31/2020",31930,367918,76211,0,""
MA,"01/07/2021",36135,404053,137858,0,""
MA,"01/14/2021",44394,448447,233476,0,""
MA,"01/21/2021",32593,481040,353117,0,""
MA,"01/28/2021",28463,509503,490332,0,""
MA,"02/04/2021",21614,531117,652929,0,""
MA,"02/11/2021",17829,548946,924612,0,""
MA,"02/18/2021",12990,561936,1214821,0,""
MA,"02/25/2021",11949,573885,1576657,0,""
MA,"03/04/2021",10861,584746,1941018,0,""
MA,"03/11/2021",10518,595264,2376322,776259,""
MA,"03/18/2021",11113,606377,2773542,969041,""
MA,"03/25/2021",13439,619816,3196050,1137413,""
MA,"04/01/2021",15764,635580,3685186,1341408,""
MA,"04/08/2021",14993,650573,4252091,1580322,""
MA,"04/15/2021",14370,664943,4895087,1892688,""
MA,"04/22/2021",11815,676758,5467558,2156940,""
MA,"04/29/2021",9485,686243,6087168,2461918,""
MA,"05/06/2021",7365,693608,6588555,2745439,""
MA,"05/13/2021",5579,699187,7103369,3087288,""
MA,"05/20/2021",4105,703292,7488346,3333097,""
MA,"05/27/2021",2735,706027,7849273,3566470,""
MA,"06/03/2021",1238,707265,8111038,3740479,""
MA,"06/10/2021",1194,708459,8398807,3937546,""
MA,"06/17/2021",620,709079,8588503,4072441,""
MA,"06/24/2021",464,709543,8721461,4161157,""
MA,"07/01/2021",423,709966,8858362,4256952,""
MA,"07/08/2021",552,710518,8924358,4296281,""
MA,"07/15/2021",1158,711676,8989629,4333539,""
MA,"07/22/2021",2338,714014,9051266,4366341,""
MA,"07/29/2021",3930,717944,9113239,4393827,""
MA,"08/05/2021",6074,724018,9188927,4425475,""
MA,"08/12/2021",7803,731821,9253493,4451811,""
MA,"08/19/2021",8805,740626,9327409,4483417,""
MA,"08/26/2021",9622,750248,9409796,4518695,0
MA,"09/02/2021",11658,761906,9498168,4558121,0
MA,"09/09/2021",10836,772742,9568210,4587929,0
MA,"09/16/2021",13885,786627,9641149,4620288,0
MA,"09/23/2021",12278,798905,9712378,4653594,0
MA,"09/30/2021",11414,810319,9798631,4679810,0
MA,"10/07/2021",9620,819939,9927382,4708171,0
MA,"10/14/2021",9934,829873,10051914,4735074,0
MA,"10/21/2021",9944,839817,10178352,4762192,276051
MA,"10/28/2021",9130,848947,10356035,4791152,381353
MA,"11/04/2021",9012,857959,10583168,4815714,532373
MA,"11/11/2021",11334,869293,10851024,4840701,695975
MA,"11/18/2021",15006,884299,11152391,4863781,852256
MA,"11/25/2021",20108,904407,11415048,4883284,1004353
MA,"12/02/2021",19993,924400,11696256,4924144,1171688
MA,"12/09/2021",33489,957889,12058256,5003369,1377951
MA,"12/16/2021",33820,991709,12422213,5075651,1595070
MA,"12/23/2021",43022,1034731,12760499,5114904,1816313
MA,"12/30/2021",61094,1095825,12981917,5140101,1959239
MA,"01/06/2022",127529,1223354,13186234,5166045,2086852
MA,"01/13/2022",166550,1389904,13444102,5198480,2242106
MA,"01/20/2022",113494,1503398,13673242,5229611,2374590
MA,"01/27/2022",77207,1580605,13854824,5255176,2470020
MA,"02/03/2022",39663,1620268,13975406,5278183,2525822
MA,"02/10/2022",22578,1642846,14073026,5304474,2566385
MA,"02/17/2022",13499,1656345,14165491,5328858,2602694
MA,"02/24/2022",10277,1666622,14240010,5347614,2633508
MA,"03/03/2022",6990,1673612,14297164,5355873,2656895
MA,"03/10/2022",5422,1679034,14342533,5367438,2675592
MA,"03/17/2022",5002,1684036,14377119,5375341,2689958
MA,"03/24/2022",5714,1689750,14412068,5381216,2704918
MA,"03/31/2022",7415,1697165,14438178,5387612,2716291
MA,"04/07/2022",8995,1706160,14525000,5400737,2734010
MA,"04/14/2022",12227,1718387,14630625,5414486,2751459
MA,"04/21/2022",14769,1733156,14724673,5426580,2766932
MA,"04/28/2022",16620,1749776,14815095,5438006,2781816
MA,"05/05/2022",20525,1770301,14903376,5449039,2795884
MA,"05/12/2022",27007,1797308,14973037,5458519,2807252
MA,"05/19/2022",32720,1830028,15070745,5470408,2823159
MA,"05/26/2022",25472,1855500,15152555,5480691,2838595
MA,"06/02/2022",17534,1873034,15211413,5488221,2852158
MA,"06/09/2022",16514,1889548,15273383,5496418,2867466
MA,"06/16/2022",12519,1902067,15318285,5502236,2879644
MD,"12/17/2020",19114,241767,3,0,""
MD,"12/24/2020",16095,257862,11800,0,""
MD,"12/31/2020",15827,273689,50312,0,""
MD,"01/07/2021",19215,292904,100049,0,""
MD,"01/14/2021",21963,314867,194705,0,""
MD,"01/21/2021",17486,332353,271905,0,""
MD,"01/28/2021",14206,346559,412206,0,""
MD,"02/04/2021",10924,357483,565821,0,""
MD,"02/11/2021",9183,366666,745478,0,""
MD,"02/18/2021",6314,372980,930567,0,""
MD,"02/25/2021",5510,378490,1199143,0,""
MD,"03/04/2021",5469,383959,1497538,0,""
MD,"03/11/2021",5607,389566,1812309,688419,""
MD,"03/18/2021",6067,395633,2130973,798449,""
MD,"03/25/2021",6967,402600,2464830,896207,""
MD,"04/01/2021",8744,411344,2882170,1075960,""
MD,"04/08/2021",9182,420526,3330227,1300334,""
MD,"04/15/2021",9825,430351,3837451,1567793,""
MD,"04/22/2021",8439,438790,4315837,1805523,""
MD,"04/29/2021",6703,445493,4733768,2023126,""
MD,"05/06/2021",5196,450689,5006410,2188349,""
MD,"05/13/2021",3582,454271,5408440,2466731,""
MD,"05/20/2021",2494,456765,5758938,2674631,""
MD,"05/27/2021",2114,458879,6030957,2835588,""
MD,"06/03/2021",1188,460067,6186967,2931258,""
MD,"06/10/2021",796,460863,6377412,3059269,""
MD,"06/17/2021",607,461470,6612831,3219251,""
MD,"06/24/2021",417,461887,6719727,3288245,""
MD,"07/01/2021",392,462279,6891344,3394301,""
MD,"07/08/2021",458,462737,6965180,3437544,""
MD,"07/15/2021",751,463488,7039584,3478529,""
MD,"07/22/2021",1247,464735,7109034,3514298,""
MD,"07/29/2021",2196,466931,7185150,3546450,""
MD,"08/05/2021",3674,470605,7267577,3580351,""
MD,"08/12/2021",5465,476070,7347058,3611110,""
MD,"08/19/2021",6511,482581,7432879,3646818,""
MD,"08/26/2021",7349,489930,7528234,3687462,0
MD,"09/02/2021",8446,498376,7614991,3724833,0
MD,"09/09/2021",7181,505557,7711259,3767698,0
MD,"09/16/2021",8372,513929,7799862,3807156,0
MD,"09/23/2021",8426,522355,7877281,3845328,0
MD,"09/30/2021",8506,530861,7969400,3876526,0
MD,"10/07/2021",8192,539053,8098322,3908280,0
MD,"10/14/2021",7499,546552,8204525,3934817,0
MD,"10/21/2021",5972,552524,8321252,3964440,254248
MD,"10/28/2021",5399,557923,8488260,3992506,359975
MD,"11/04/2021",4973,562896,8649939,3996775,503125
MD,"11/11/2021",5033,567929,8858896,4021848,651797
MD,"11/18/2021",5906,573835,9046525,4042361,784313
MD,"11/25/2021",6661,580496,9329572,4061450,912498
MD,"12/02/2021",6789,587285,9532394,4103709,1029927
MD,"12/09/2021",9766,597051,9801258,4161947,1192613
MD,"12/16/2021",11223,608274,10033390,4206379,1336940
MD,"12/23/2021",24742,633016,10270543,4236445,1490027
MD,"12/30/2021",59245,692261,10434341,4256109,1597122
MD,"01/06/2022",96123,788384,10569548,4275073,1682504
MD,"01/13/2022",90295,878679,10788208,4310596,1811186
MD,"01/20/2022",54861,933540,10974567,4352618,1917794
MD,"01/27/2022",31561,965101,11113028,4376894,1994831
MD,"02/03/2022",15325,980426,11222522,4401324,2052885
MD,"02/10/2022",9106,989532,11315866,4427003,2099285
MD,"02/17/2022",5047,994579,11419484,4451535,2136690
MD,"02/24/2022",4650,999229,11477997,4467987,2163117
MD,"03/03/2022",3810,1003039,11540342,4484134,2190561
MD,"03/10/2022",2294,1005333,11579870,4493417,2209401
MD,"03/17/2022",2039,1007372,11611964,4501261,2224118
MD,"03/24/2022",1972,1009344,11643639,4509202,2238397
MD,"03/31/2022",2154,1011498,11716639,4530532,2261245
MD,"04/07/2022",2725,1014223,11798520,4541332,2277111
MD,"04/14/2022",3703,1017926,11931236,4584872,2297677
MD,"04/21/2022",4935,1022861,11951370,4559856,2304198
MD,"04/28/2022",5892,1028753,12018729,4567278,2316081
MD,"05/05/2022",7585,1036338,12088280,4576482,2329106
MD,"05/12/2022",10923,1047261,12146202,4582996,2338887
MD,"05/19/2022",14974,1062235,12224923,4590123,2350695
MD,"05/26/2022",15887,1078122,12308354,4597547,2365907
MD,"06/02/2022",15319,1093441,12370426,4603436,2379460
MD,"06/09/2022",10643,1104084,12427217,4609853,2392068
MD,"06/16/2022",9765,1113849,12481777,4615638,2404138
ME,"12/17/2020",3040,17901,3,0,""
ME,"12/24/2020",3325,21226,11958,0,""
ME,"12/31/2020",2975,24201,23345,0,""
ME,"01/07/2021",3424,27625,37128,0,""
ME,"01/14/2021",4333,31958,61129,0,""
ME,"01/21/2021",3680,35638,80502,0,""
ME,"01/28/2021",2816,38454,115191,0,""
ME,"02/04/2021",2080,40534,153439,0,""
ME,"02/11/2021",1530,42064,193246,0,""
ME,"02/18/2021",1031,43095,242445,0,""
ME,"02/25/2021",1023,44118,305397,0,""
ME,"03/04/2021",1113,45231,334528,0,""
ME,"03/11/2021",1217,46448,442593,157423,""
ME,"03/18/2021",1384,47832,528977,193255,""
ME,"03/25/2021",1358,49190,620556,231260,""
ME,"04/01/2021",1598,50788,715036,271683,""
ME,"04/08/2021",2208,52996,829113,336903,""
ME,"04/15/2021",2958,55954,966930,414949,""
ME,"04/22/2021",2914,58868,1068265,464656,""
ME,"04/29/2021",2077,60945,1165567,517435,""
ME,"05/06/2021",2231,63176,1247314,573346,""
ME,"05/13/2021",1869,65045,1324706,635150,""
ME,"05/20/2021",1490,66535,1393589,680621,""
ME,"05/27/2021",889,67424,1462994,720554,""
ME,"06/03/2021",562,67986,1497916,742131,""
ME,"06/10/2021",463,68449,1535266,768976,""
ME,"06/17/2021",271,68720,1572628,797386,""
ME,"06/24/2021",169,68889,1594846,812689,""
ME,"07/01/2021",165,69054,1615250,827255,""
ME,"07/08/2021",136,69190,1629452,836042,""
ME,"07/15/2021",183,69373,1640525,842539,""
ME,"07/22/2021",408,69781,1650508,847199,""
ME,"07/29/2021",481,70262,1662189,852049,""
ME,"08/05/2021",734,70996,1679689,861597,""
ME,"08/12/2021",1123,72119,1692077,865987,""
ME,"08/19/2021",1152,73271,1707899,872212,""
ME,"08/26/2021",1432,74703,1727343,879281,0
ME,"09/02/2021",2210,76913,1748970,887309,0
ME,"09/09/2021",2495,79408,1764861,894004,0
ME,"09/16/2021",3199,82607,1784167,903390,0
ME,"09/23/2021",3265,85872,1802929,913647,0
ME,"09/30/2021",4117,89989,1824230,921333,0
ME,"10/07/2021",3898,93887,1845374,925935,0
ME,"10/14/2021",2753,96640,1873407,932356,0
ME,"10/21/2021",3167,99807,1908440,940142,62167
ME,"10/28/2021",2662,102469,1948534,946354,87460
ME,"11/04/2021",4004,106473,2009298,952454,130329
ME,"11/11/2021",3874,110347,2070635,958389,172301
ME,"11/18/2021",3718,114065,2138582,964009,210582
ME,"11/25/2021",4424,118489,2198768,968553,248143
ME,"12/02/2021",2963,121452,2253584,974851,284954
ME,"12/09/2021",5381,126833,2325660,990280,328426
ME,"12/16/2021",7337,134170,2399182,1005449,374344
ME,"12/23/2021",5251,139421,2468056,1014290,421517
ME,"12/30/2021",6208,145629,2508118,1019209,448113
ME,"01/06/2022",5216,150845,2544813,1024121,471758
ME,"01/13/2022",7242,158087,2587892,1030026,499696
ME,"01/20/2022",6239,164326,2623366,1036524,522595
ME,"01/27/2022",7198,171524,2648294,1040548,537881
ME,"02/03/2022",6978,178502,2662930,1043619,546109
ME,"02/10/2022",6112,184614,2676056,1047138,552835
ME,"02/17/2022",21391,206005,2690347,1050461,559023
ME,"02/24/2022",16920,222925,2699754,1052865,563712
ME,"03/03/2022",6282,229207,2707100,1054262,567278
ME,"03/10/2022",2541,231748,2714243,1056034,570841
ME,"03/17/2022",1448,233196,2720365,1056759,573840
ME,"03/24/2022",1219,234415,2726115,1057812,576764
ME,"03/31/2022",1375,235790,2731764,1059244,579645
ME,"04/07/2022",1428,237218,2753653,1061393,583995
ME,"04/14/2022",1912,239130,2783185,1063870,588634
ME,"04/21/2022",2119,241249,2809780,1066257,592521
ME,"04/28/2022",2343,243592,2834242,1068476,595994
ME,"05/05/2022",5206,248798,2856302,1070512,599085
ME,"05/12/2022",4856,253654,2877363,1072464,602133
ME,"05/19/2022",4095,257749,2898126,1074162,605224
ME,"05/26/2022",3838,261587,2916843,1075832,608232
ME,"06/02/2022",2127,263714,2931557,1077180,610925
ME,"06/09/2022",1857,265571,2944812,1078480,613684
ME,"06/16/2022",1611,267182,2954541,1079500,615734
MI,"12/17/2020",34366,482781,244,0,""
MI,"12/24/2020",25662,508443,16504,0,""
MI,"12/31/2020",20150,528593,68398,0,""
MI,"01/07/2021",22905,551498,156251,0,""
MI,"01/14/2021",21780,573278,364182,0,""
MI,"01/21/2021",16591,589869,548844,0,""
MI,"01/28/2021",14358,604227,814416,0,""
MI,"02/04/2021",11608,615835,1078808,0,""
MI,"02/11/2021",9135,624970,1412047,0,""
MI,"02/18/2021",7802,632772,1718790,0,""
MI,"02/25/2021",8496,641268,2103114,0,""
MI,"03/04/2021",9494,650762,2476796,0,""
MI,"03/11/2021",11811,662573,2899309,1050447,""
MI,"03/18/2021",17706,680279,3396328,1243440,""
MI,"03/25/2021",26273,706552,3914742,1458881,""
MI,"04/01/2021",39799,746351,4514072,1735920,""
MI,"04/08/2021",49141,795492,5112551,2039778,""
MI,"04/15/2021",55092,850584,5805782,2423714,""
MI,"04/22/2021",44863,895447,6440845,2765862,""
MI,"04/29/2021",32960,928407,7023900,3118484,""
MI,"05/06/2021",23493,951900,7449790,3413191,""
MI,"05/13/2021",18476,970376,7875785,3724513,""
MI,"05/20/2021",12023,982399,8246377,3954752,""
MI,"05/27/2021",7600,989999,8570263,4134551,""
MI,"06/03/2021",3425,993424,8742979,4234717,""
MI,"06/10/2021",2634,996058,8952922,4376010,""
MI,"06/17/2021",1740,997798,9185561,4540507,""
MI,"06/24/2021",1054,998852,9313318,4624503,""
MI,"07/01/2021",1109,999961,9438647,4709737,""
MI,"07/08/2021",935,1000896,9494060,4744557,""
MI,"07/15/2021",1572,1002468,9608785,4800032,""
MI,"07/22/2021",2160,1004628,9699731,4837915,""
MI,"07/29/2021",3800,1008428,9775528,4867569,""
MI,"08/05/2021",5657,1014085,9853367,4900413,""
MI,"08/12/2021",10919,1025004,9931532,4931926,""
MI,"08/19/2021",10820,1035824,10015494,4968423,""
MI,"08/26/2021",14329,1050153,10112558,5010513,0
MI,"09/02/2021",15518,1065671,10219092,5057861,0
MI,"09/09/2021",15513,1081184,10291085,5090783,0
MI,"09/16/2021",21773,1102957,10377873,5131130,0
MI,"09/23/2021",22607,1125564,10505445,5187960,0
MI,"09/30/2021",24500,1150064,10627069,5221120,0
MI,"10/07/2021",28844,1178908,10813173,5264919,0
MI,"10/14/2021",30818,1209726,11020234,5274332,0
MI,"10/21/2021",28119,1237845,11123961,5294112,405446
MI,"10/28/2021",27536,1265381,11374039,5332993,580204
MI,"11/04/2021",32115,1297496,11642444,5359104,790023
MI,"11/11/2021",31593,1329089,11931023,5386238,995654
MI,"11/18/2021",58849,1387938,12261664,5412454,1192271
MI,"11/25/2021",59292,1447230,12554249,5433838,1397768
MI,"12/02/2021",47723,1494953,12844066,5470903,1594676
MI,"12/09/2021",58837,1553790,13178300,5538735,1811660
MI,"12/16/2021",45890,1599680,13498695,5599581,2025642
MI,"12/23/2021",45898,1645578,13791653,5644292,2228391
MI,"12/30/2021",64747,1710325,13979476,5673450,2353572
MI,"01/06/2022",98413,1808738,14151800,5702584,2463729
MI,"01/13/2022",131970,1940708,14354925,5737156,2593161
MI,"01/20/2022",142272,2082980,14524082,5771005,2700056
MI,"01/27/2022",120666,2203646,14650604,5797034,2774995
MI,"02/03/2022",79364,2283010,14772719,5824508,2844676
MI,"02/10/2022",33861,2316871,14877836,5854113,2897639
MI,"02/17/2022",20535,2337406,15059670,5883644,2972712
MI,"02/24/2022",13062,2350468,15173971,5906732,3036731
MI,"03/03/2022",13050,2363518,15264748,5923005,3093455
MI,"03/10/2022",6339,2369857,15363600,5942850,3149060
MI,"03/17/2022",5569,2375426,15394339,5951610,3163593
MI,"03/24/2022",6749,2382175,15424860,5959340,3178400
MI,"03/31/2022",5322,2387497,15460686,5967627,3196001
MI,"04/07/2022",5761,2393258,15559087,5976672,3211102
MI,"04/14/2022",7724,2400982,15667286,5986009,3225920
MI,"04/21/2022",10481,2411463,15757161,5994110,3238696
MI,"04/28/2022",14483,2425946,15841751,6002679,3251234
MI,"05/05/2022",18945,2444891,15922751,6011530,3264037
MI,"05/12/2022",27705,2472596,15992798,6019133,3275402
MI,"05/19/2022",29267,2501863,16067654,6026365,3287304
MI,"05/26/2022",25968,2527831,16146930,6033637,3301037
MI,"06/02/2022",19535,2547366,16205395,6039571,3313637
MI,"06/09/2022",18453,2565819,16254418,6045512,3324502
MI,"06/16/2022",15578,2581397,16281256,6048847,3331267
MN,"12/17/2020",22663,385641,0,0,""
MN,"12/24/2020",16087,401728,25795,0,""
MN,"12/31/2020",10649,412377,61399,0,""
MN,"01/07/2021",14468,426845,97098,0,""
MN,"01/14/2021",12783,439628,198253,0,""
MN,"01/21/2021",9163,448791,259417,0,""
MN,"01/28/2021",7822,456613,403640,0,""
MN,"02/04/2021",6515,463128,634453,0,""
MN,"02/11/2021",6162,469290,754262,0,""
MN,"02/18/2021",5508,474798,957275,0,""
MN,"02/25/2021",5487,480285,1218799,0,""
MN,"03/04/2021",5600,485885,1512877,0,""
MN,"03/11/2021",6611,492496,1823592,646257,""
MN,"03/18/2021",6949,499445,2119439,777983,""
MN,"03/25/2021",8592,508037,2417606,900932,""
MN,"04/01/2021",10981,519018,2800651,1088094,""
MN,"04/08/2021",13112,532130,3187097,1286847,""
MN,"04/15/2021",14434,546564,3597769,1524901,""
MN,"04/22/2021",13330,559894,3939904,1701368,""
MN,"04/29/2021",11551,571445,4293491,1890871,""
MN,"05/06/2021",10498,581943,4576900,2064938,""
MN,"05/13/2021",7874,589817,4847982,2255008,""
MN,"05/20/2021",5728,595545,5102426,2417991,""
MN,"05/27/2021",3742,599287,5331457,2548636,""
MN,"06/03/2021",1736,601023,5443328,2615971,""
MN,"06/10/2021",1519,602542,5571881,2702368,""
MN,"06/17/2021",991,603533,5695478,2795379,""
MN,"06/24/2021",768,604301,5775732,2849697,""
MN,"07/01/2021",658,604959,5884070,2931705,""
MN,"07/08/2021",706,605665,5927284,2957242,""
MN,"07/15/2021",1039,606704,5971070,2982412,""
MN,"07/22/2021",1618,608322,6014134,3004997,""
MN,"07/29/2021",2779,611101,6063107,3025760,""
MN,"08/05/2021",4449,615550,6120621,3047240,""
MN,"08/12/2021",6288,621838,6184115,3068967,""
MN,"08/19/2021",8295,630133,6251995,3093823,""
MN,"08/26/2021",9926,640059,6325842,3126119,0
MN,"09/02/2021",10937,650996,6403934,3163850,0
MN,"09/09/2021",11872,662868,6467896,3196027,0
MN,"09/16/2021",13249,676117,6533378,3229050,0
MN,"09/23/2021",15328,691445,6588723,3256719,0
MN,"09/30/2021",16463,707908,6665091,3280065,0
MN,"10/07/2021",21110,729018,6764831,3299755,0
MN,"10/14/2021",19851,748869,6900376,3325732,0
MN,"10/21/2021",16635,765504,7001256,3345065,291385
MN,"10/28/2021",15854,781358,7135788,3367124,385869
MN,"11/04/2021",26423,807781,7424031,3463757,542219
MN,"11/11/2021",23741,831522,7631276,3479780,693252
MN,"11/18/2021",29551,861073,7879189,3494955,846550
MN,"11/25/2021",29869,890942,8109317,3508269,1005384
MN,"12/02/2021",24779,915721,8322440,3539329,1150745
MN,"12/09/2021",32567,948288,8587258,3593902,1325977
MN,"12/16/2021",23176,971464,8820702,3644981,1479287
MN,"12/23/2021",21200,992664,9006530,3671342,1611247
MN,"12/30/2021",22554,1015218,9135876,3689641,1699033
MN,"01/06/2022",33814,1049032,9257644,3709567,1778616
MN,"01/13/2022",65817,1114849,9401277,3732963,1870758
MN,"01/20/2022",78179,1193028,9527970,3755686,1952529
MN,"01/27/2022",86825,1279853,9624650,3772286,2011022
MN,"02/03/2022",66360,1346213,9708525,3789527,2056979
MN,"02/10/2022",31988,1378201,9780805,3808729,2092794
MN,"02/17/2022",21447,1399648,9836560,3824931,2117764
MN,"02/24/2022",10113,1409761,9881179,3839758,2137525
MN,"03/03/2022",5862,1415623,9920537,3852940,2154344
MN,"03/10/2022",4590,1420213,9949570,3860960,2167677
MN,"03/17/2022",3068,1423281,9972230,3866906,2178229
MN,"03/24/2022",2802,1426083,9993291,3871896,2188091
MN,"03/31/2022",2775,1428858,10014874,3876632,2198371
MN,"04/07/2022",2981,1431839,10073290,3882067,2209112
MN,"04/14/2022",3932,1435771,10149150,3887635,2219198
MN,"04/21/2022",5379,1441150,10225081,3892805,2229607
MN,"04/28/2022",7653,1448803,10294968,3897629,2238919
MN,"05/05/2022",10421,1459224,10358539,3902706,2248718
MN,"05/12/2022",14188,1473412,10420767,3907463,2257663
MN,"05/19/2022",14803,1488215,10478931,3911726,2266295
MN,"05/26/2022",12247,1500462,10545141,3916319,2278071
MN,"06/02/2022",8398,1508860,10595024,3919921,2287916
MN,"06/09/2022",14357,1523217,10644816,3923834,2298612
MN,"06/16/2022",10569,1533786,10673342,3926159,2304649
MO,"12/17/2020",27821,384766,2423,0,""
MO,"12/24/2020",24607,409373,33368,0,""
MO,"12/31/2020",20927,430300,79047,0,""
MO,"01/07/2021",25589,455889,113369,0,""
MO,"01/14/2021",24242,480131,190447,0,""
MO,"01/21/2021",17476,497607,265382,0,""
MO,"01/28/2021",15000,512607,382552,0,""
MO,"02/04/2021",11815,524422,505207,0,""
MO,"02/11/2021",9021,533443,694992,0,""
MO,"02/18/2021",5840,539283,915475,0,""
MO,"02/25/2021",6109,545392,1167787,0,""
MO,"03/04/2021",4189,549581,1458439,0,""
MO,"03/11/2021",4220,553801,1724580,581876,""
MO,"03/18/2021",4382,558183,1989274,681207,""
MO,"03/25/2021",4492,562675,2276318,789831,""
MO,"04/01/2021",4102,566777,2576981,954162,""
MO,"04/08/2021",4017,570794,2970903,1139410,""
MO,"04/15/2021",4464,575258,3310684,1322317,""
MO,"04/22/2021",4431,579689,3639625,1489436,""
MO,"04/29/2021",4387,584076,3947226,1655078,""
MO,"05/06/2021",4778,588854,4152250,1796371,""
MO,"05/13/2021",3183,592037,4348456,1939858,""
MO,"05/20/2021",2936,594973,4501899,2025458,""
MO,"05/27/2021",3167,598140,4626406,2083257,""
MO,"06/03/2021",2872,601012,4700811,2122323,""
MO,"06/10/2021",3492,604504,4797636,2182755,""
MO,"06/17/2021",4227,608731,4920661,2272493,""
MO,"06/24/2021",5093,613824,5033569,2350035,""
MO,"07/01/2021",6394,620218,5122970,2403164,""
MO,"07/08/2021",7976,628194,5175778,2425291,""
MO,"07/15/2021",12288,640482,5243381,2452207,""
MO,"07/22/2021",15792,656274,5331280,2484985,""
MO,"07/29/2021",18345,674619,5430359,2521522,""
MO,"08/05/2021",19646,694265,5535752,2562424,""
MO,"08/12/2021",19426,713691,5645732,2613256,""
MO,"08/19/2021",18113,731804,5730840,2656142,""
MO,"08/26/2021",16437,748241,5887283,2734843,0
MO,"09/02/2021",16117,764358,5972539,2779556,0
MO,"09/09/2021",14546,778904,6051642,2820554,0
MO,"09/16/2021",16443,795347,6135215,2865583,0
MO,"09/23/2021",13524,808871,6204731,2902487,0
MO,"09/30/2021",11871,820742,6304426,2941505,0
MO,"10/07/2021",10198,830940,6420189,2972580,0
MO,"10/14/2021",8169,839109,6524790,3000835,0
MO,"10/21/2021",7272,846381,6615814,3022163,217671
MO,"10/28/2021",6935,853316,6724837,3044188,283306
MO,"11/04/2021",7166,860482,6866180,3064276,378668
MO,"11/11/2021",9249,869731,7036579,3085743,484235
MO,"11/18/2021",9935,879666,7184242,3101256,557670
MO,"11/25/2021",11813,891479,7329322,3117242,642006
MO,"12/02/2021",13770,905249,7468812,3138356,722118
MO,"12/09/2021",18938,924187,7675886,3181734,841891
MO,"12/16/2021",19542,943729,7860343,3217378,949074
MO,"12/23/2021",21639,965368,8018325,3241376,1047095
MO,"12/30/2021",32046,997414,8088236,3254448,1087875
MO,"01/06/2022",61015,1058429,8147461,3264934,1121026
MO,"01/13/2022",80463,1138892,8272599,3285699,1192676
MO,"01/20/2022",84285,1223177,8377068,3314873,1253539
MO,"01/27/2022",72834,1296011,8459346,3328491,1298302
MO,"02/03/2022",44426,1340437,8521617,3343813,1329200
MO,"02/10/2022",25032,1365469,8555883,3355247,1343204
MO,"02/17/2022",13598,1379067,8609207,3369032,1361937
MO,"02/24/2022",7685,1386752,8640760,3378567,1375196
MO,"03/03/2022",5367,1392119,8663889,3385294,1386001
MO,"03/10/2022",3988,1396107,8695633,3395307,1399728
MO,"03/17/2022",3223,1399330,8715204,3401479,1407550
MO,"03/24/2022",2824,1402154,8734276,3406870,1415923
MO,"03/31/2022",3094,1405248,8751523,3411127,1423885
MO,"04/07/2022",3501,1408749,8793985,3418187,1432895
MO,"04/14/2022",2544,1411293,8840152,3425119,1441076
MO,"04/21/2022",3285,1414578,8890552,3432778,1449194
MO,"04/28/2022",4502,1419080,8929881,3438275,1455866
MO,"05/05/2022",4772,1423852,8965290,3443314,1462211
MO,"05/12/2022",6383,1430235,8999092,3448237,1468544
MO,"05/19/2022",7732,1437967,9034906,3453117,1475424
MO,"05/26/2022",8015,1445982,9073528,3458040,1483655
MO,"06/02/2022",9669,1455651,9105582,3462478,1491323
MO,"06/09/2022",11225,1466876,9139173,3467031,1499138
MO,"06/16/2022",10971,1477847,9169683,3471247,1506448
MP,"12/17/2020",0,113,0,0,""
MP,"12/24/2020",5,118,691,0,""
MP,"12/31/2020",4,122,2709,0,""
MP,"01/07/2021",3,125,3090,0,""
MP,"01/14/2021",3,128,4598,0,""
MP,"01/21/2021",1,129,7309,0,""
MP,"01/28/2021",3,132,9251,0,""
MP,"02/04/2021",1,133,10966,0,""
MP,"02/11/2021",0,133,12728,0,""
MP,"02/18/2021",2,135,15112,0,""
MP,"02/25/2021",8,143,17473,0,""
MP,"03/04/2021",1,144,19580,0,""
MP,"03/11/2021",2,146,21323,8881,""
MP,"03/18/2021",10,156,23266,9692,""
MP,"03/25/2021",2,158,26016,10888,""
MP,"04/01/2021",1,159,28918,12178,""
MP,"04/08/2021",1,160,31237,13062,""
MP,"04/15/2021",1,161,34303,14626,""
MP,"04/22/2021",1,162,37240,16280,""
MP,"04/29/2021",2,164,39728,17811,""
MP,"05/06/2021",4,168,42045,19224,""
MP,"05/13/2021",2,170,43854,20309,""
MP,"05/20/2021",6,176,45783,21304,""
MP,"05/27/2021",5,181,47589,22166,""
MP,"06/03/2021",2,183,49048,22940,""
MP,"06/10/2021",0,183,50632,23714,""
MP,"06/17/2021",0,183,52480,24844,""
MP,"06/24/2021",0,183,54235,25780,""
MP,"07/01/2021",0,183,55616,26530,""
MP,"07/08/2021",1,184,56857,27248,""
MP,"07/15/2021",3,187,58320,28102,""
MP,"07/22/2021",1,188,59878,28780,""
MP,"07/29/2021",2,190,60984,29314,""
MP,"08/05/2021",8,198,62273,29941,""
MP,"08/12/2021",12,210,63621,30690,""
MP,"08/19/2021",10,220,64916,31348,""
MP,"08/26/2021",9,229,66082,32002,0
MP,"09/02/2021",14,243,67033,32556,0
MP,"09/09/2021",5,248,68123,33173,0
MP,"09/16/2021",8,256,68760,33470,0
MP,"09/23/2021",9,265,69509,33896,0
MP,"09/30/2021",3,268,69991,34110,0
MP,"10/07/2021",4,272,70620,34325,0
MP,"10/14/2021",9,281,71165,34486,0
MP,"10/21/2021",8,289,71634,34579,1772
MP,"10/28/2021",2,291,72328,34774,2127
MP,"11/04/2021",39,330,73973,34957,3290
MP,"11/11/2021",50,380,76269,35111,4690
MP,"11/18/2021",28,408,78375,35238,5627
MP,"11/25/2021",196,604,78375,35240,5628
MP,"12/02/2021",354,958,83524,36269,7931
MP,"12/09/2021",224,1182,86790,37463,8946
MP,"12/16/2021",935,2117,90780,38402,11156
MP,"12/23/2021",524,2641,94171,39248,13007
MP,"12/30/2021",444,3085,95793,39878,13714
MP,"01/06/2022",433,3518,97702,40705,14454
MP,"01/13/2022",233,3751,99523,41329,15354
MP,"01/20/2022",367,4118,100951,41675,16180
MP,"01/27/2022",446,4564,102286,41965,16947
MP,"02/03/2022",750,5314,103154,42156,17458
MP,"02/10/2022",1470,6784,104215,42392,18113
MP,"02/17/2022",1143,7927,104940,42596,18535
MP,"02/24/2022",1338,9265,105571,42743,18928
MP,"03/03/2022",657,9922,106131,42913,19222
MP,"03/10/2022",362,10284,106791,43030,19637
MP,"03/17/2022",291,10575,107094,43069,19852
MP,"03/24/2022",410,10985,107436,43106,20092
MP,"03/31/2022",80,11065,107876,43165,20409
MP,"04/07/2022",93,11158,108169,43199,20616
MP,"04/14/2022",45,11203,108496,43238,20756
MP,"04/21/2022",18,11221,108822,43265,20914
MP,"04/28/2022",42,11263,108863,43268,20923
MP,"05/05/2022",18,11281,109148,43314,21018
MP,"05/12/2022",24,11305,109240,43334,21042
MP,"05/19/2022",10,11315,109387,43344,21097
MP,"05/26/2022",18,11333,109636,43371,21203
MP,"06/02/2022",33,11366,109753,43379,21262
MP,"06/09/2022",37,11403,109799,43380,21287
MP,"06/16/2022",79,11482,110104,43411,21447
MS,"12/17/2020",14971,185643,74,0,""
MS,"12/24/2020",14682,200325,7167,0,""
MS,"12/31/2020",12730,213055,16950,0,""
MS,"01/07/2021",15180,228235,28356,0,""
MS,"01/14/2021",15664,243899,71848,0,""
MS,"01/21/2021",12928,256827,136691,0,""
MS,"01/28/2021",11845,268672,201247,0,""
MS,"02/04/2021",8650,277322,250905,0,""
MS,"02/11/2021",6432,283754,365400,0,""
MS,"02/18/2021",5644,289398,438364,0,""
MS,"02/25/2021",2494,291892,525981,0,""
MS,"03/04/2021",3784,295676,685610,0,""
MS,"03/11/2021",2769,298445,823604,298373,""
MS,"03/18/2021",3157,301602,940902,343155,""
MS,"03/25/2021",2023,303625,1049528,392516,""
MS,"04/01/2021",1521,305146,1160150,452143,""
MS,"04/08/2021",1465,306611,1289701,528936,""
MS,"04/15/2021",1464,308075,1410771,599482,""
MS,"04/22/2021",1645,309720,1503377,652463,""
MS,"04/29/2021",1639,311359,1565428,692450,""
MS,"05/06/2021",1347,312706,1626229,729619,""
MS,"05/13/2021",1444,314150,1674671,759328,""
MS,"05/20/2021",1744,315894,1721447,784434,""
MS,"05/27/2021",1170,317064,1756662,801053,""
MS,"06/03/2021",793,317857,1790189,817730,""
MS,"06/10/2021",828,318685,1822981,834928,""
MS,"06/17/2021",827,319512,1856117,855639,""
MS,"06/24/2021",780,320292,1879230,868653,""
MS,"07/01/2021",1472,321764,1913415,888154,""
MS,"07/08/2021",1453,323217,2035918,990469,""
MS,"07/15/2021",2496,325713,2060045,1001141,""
MS,"07/22/2021",4951,330664,2092384,1012480,""
MS,"07/29/2021",9290,339954,2131467,1022667,""
MS,"08/05/2021",12937,352891,2188525,1035458,""
MS,"08/12/2021",18821,371712,2265054,1055521,""
MS,"08/19/2021",24682,396394,2335398,1078701,""
MS,"08/26/2021",23780,420174,2415499,1109015,0
MS,"09/02/2021",19487,439661,2495829,1144438,0
MS,"09/09/2021",15621,455282,2610640,1199266,0
MS,"09/16/2021",13216,468498,2684119,1241211,0
MS,"09/23/2021",10828,479326,2730863,1269033,0
MS,"09/30/2021",7967,487293,2783784,1294972,0
MS,"10/07/2021",5266,492559,2830765,1311697,0
MS,"10/14/2021",4292,496851,2870760,1325520,0
MS,"10/21/2021",3435,500286,2916983,1342667,87952
MS,"10/28/2021",3380,503666,2957744,1355557,108753
MS,"11/04/2021",1998,505664,3022248,1368016,148314
MS,"11/11/2021",2112,507776,3064548,1376494,174582
MS,"11/18/2021",2171,509947,3125351,1387438,207437
MS,"11/25/2021",2685,512632,3179082,1395494,239247
MS,"12/02/2021",2006,514638,3216798,1401882,260102
MS,"12/09/2021",3287,517925,3295371,1414541,308751
MS,"12/16/2021",2909,520834,3377622,1427687,347249
MS,"12/23/2021",4668,525502,3387349,1430031,353775
MS,"12/30/2021",13350,538852,3388047,1430507,354707
MS,"01/06/2022",33842,572694,3515156,1450300,430772
MS,"01/13/2022",36074,608768,3534726,1453639,442261
MS,"01/20/2022",56776,665544,3632687,1478363,491508
MS,"01/27/2022",40054,705598,3664119,1486295,506933
MS,"02/03/2022",32009,737607,3691735,1494974,518670
MS,"02/10/2022",35237,772844,3711544,1501718,526899
MS,"02/17/2022",10906,783750,3737753,1506969,533210
MS,"02/24/2022",4189,787939,3755138,1513239,540150
MS,"03/03/2022",2676,790615,3767328,1517620,545282
MS,"03/10/2022",1514,792129,3778600,1521806,549411
MS,"03/17/2022",1071,793200,3789095,1526028,553104
MS,"03/24/2022",670,793870,3799925,1529426,557276
MS,"03/31/2022",557,794427,3806383,1531437,560038
MS,"04/07/2022",981,795408,3818644,1534018,563550
MS,"04/14/2022",731,796139,3832571,1536426,566624
MS,"04/21/2022",506,796645,3847298,1538859,569711
MS,"04/28/2022",604,797249,3862216,1541191,572820
MS,"05/05/2022",1034,798283,3876170,1543186,575720
MS,"05/12/2022",1958,800241,3888226,1545007,578168
MS,"05/19/2022",3070,803311,3898964,1546512,580413
MS,"05/26/2022",2489,805800,3915931,1548810,583840
MS,"06/02/2022",2538,808338,3926177,1550245,586159
MS,"06/09/2022",5012,813350,3937150,1551904,588700
MS,"06/16/2022",5200,818550,3947999,1553558,591324
MT,"12/17/2020",4514,74648,1131,0,""
MT,"12/24/2020",3853,78501,8885,0,""
MT,"12/31/2020",2724,81225,17511,0,""
MT,"01/07/2021",2835,84060,27693,0,""
MT,"01/14/2021",3593,87653,46620,0,""
MT,"01/21/2021",2604,90257,60389,0,""
MT,"01/28/2021",2282,92539,86213,0,""
MT,"02/04/2021",2268,94807,116148,0,""
MT,"02/11/2021",1787,96594,149339,0,""
MT,"02/18/2021",1303,97897,190070,0,""
MT,"02/25/2021",1340,99237,252295,0,""
MT,"03/04/2021",1109,100346,301007,0,""
MT,"03/11/2021",893,101239,359446,131017,""
MT,"03/18/2021",1232,102471,414258,156863,""
MT,"03/25/2021",1187,103658,463857,175996,""
MT,"04/01/2021",883,104541,534273,210392,""
MT,"04/08/2021",980,105521,596472,240928,""
MT,"04/15/2021",1106,106627,655446,277211,""
MT,"04/22/2021",904,107531,705683,307002,""
MT,"04/29/2021",951,108482,750384,337360,""
MT,"05/06/2021",958,109440,783615,359511,""
MT,"05/13/2021",853,110293,809959,378056,""
MT,"05/20/2021",632,110925,836084,392683,""
MT,"05/27/2021",530,111455,858711,404573,""
MT,"06/03/2021",545,112000,869006,410052,""
MT,"06/10/2021",590,112590,898779,429634,""
MT,"06/17/2021",430,113020,915033,440697,""
MT,"06/24/2021",382,113402,924481,446426,""
MT,"07/01/2021",350,113752,941469,458881,""
MT,"07/08/2021",348,114100,948460,462873,""
MT,"07/15/2021",407,114507,955240,466509,""
MT,"07/22/2021",495,115002,961962,469711,""
MT,"07/29/2021",887,115889,967225,471765,""
MT,"08/05/2021",1439,117328,978918,475619,""
MT,"08/12/2021",1795,119123,988858,479129,""
MT,"08/19/2021",2258,121381,998122,482740,""
MT,"08/26/2021",2896,124277,1014056,488605,0
MT,"09/02/2021",3823,128100,1026579,493329,0
MT,"09/09/2021",3651,131751,1044575,500796,0
MT,"09/16/2021",5640,137391,1061200,508129,0
MT,"09/23/2021",6433,143824,1074405,513727,0
MT,"09/30/2021",6000,149824,1089630,518303,0
MT,"10/07/2021",6255,156079,1110918,522500,0
MT,"10/14/2021",6161,162240,1132633,527416,0
MT,"10/21/2021",6273,168513,1154583,533157,49583
MT,"10/28/2021",5571,174084,1178365,537870,64455
MT,"11/04/2021",4897,178981,1211065,541907,88439
MT,"11/11/2021",4232,183213,1246118,545790,113680
MT,"11/18/2021",3589,186802,1282428,549955,134833
MT,"11/25/2021",2876,189678,1309960,552782,152417
MT,"12/02/2021",1915,191593,1333956,555986,166815
MT,"12/09/2021",1680,193273,1366579,562817,185843
MT,"12/16/2021",1126,194399,1405611,571166,205422
MT,"12/23/2021",1022,195421,1429315,574901,220911
MT,"12/30/2021",1639,197060,1444058,577327,229743
MT,"01/06/2022",3498,200558,1454654,579273,236069
MT,"01/13/2022",7574,208132,1468697,581848,244572
MT,"01/20/2022",9915,218047,1489537,587537,254919
MT,"01/27/2022",15009,233056,1501084,589632,261565
MT,"02/03/2022",11499,244555,1510228,591611,266437
MT,"02/10/2022",9678,254233,1517703,593476,270058
MT,"02/17/2022",5467,259700,1525699,595153,272544
MT,"02/24/2022",4574,264274,1532922,597260,275480
MT,"03/03/2022",3861,268135,1537279,598629,277241
MT,"03/10/2022",3321,271456,1541224,599747,278992
MT,"03/17/2022",488,271944,1544575,600755,280429
MT,"03/24/2022",359,272303,1549212,602076,282331
MT,"03/31/2022",239,272542,1551938,602765,283488
MT,"04/07/2022",245,272787,1559094,603617,284852
MT,"04/14/2022",228,273015,1567120,604372,286085
MT,"04/21/2022",349,273364,1576350,605430,287550
MT,"04/28/2022",418,273782,1584133,606208,288780
MT,"05/05/2022",603,274385,1594360,607240,290475
MT,"05/12/2022",727,275112,1601134,607962,291556
MT,"05/19/2022",1080,276192,1605319,608406,292220
MT,"05/26/2022",1305,277497,1611299,609143,293209
MT,"06/02/2022",1496,278993,1615961,609692,294055
MT,"06/09/2022",1972,280965,1623623,610531,295472
MT,"06/16/2022",2088,283053,1629077,611197,296570
NC,"12/17/2020",42105,464314,661,0,""
NC,"12/24/2020",43808,508122,47300,0,""
NC,"12/31/2020",39700,547822,88874,0,""
NC,"01/07/2021",56256,604078,156766,0,""
NC,"01/14/2021",55744,659822,301805,0,""
NC,"01/21/2021",45861,705683,473282,0,""
NC,"01/28/2021",39078,744761,849801,0,""
NC,"02/04/2021",38806,783567,1063474,0,""
NC,"02/11/2021",26240,809807,1382652,0,""
NC,"02/18/2021",20604,830411,1782267,0,""
NC,"02/25/2021",17403,847814,2210412,0,""
NC,"03/04/2021",13574,861388,2661523,0,""
NC,"03/11/2021",11185,872573,3048105,1071902,""
NC,"03/18/2021",11286,883859,3724856,1354397,""
NC,"03/25/2021",11483,895342,4240056,1514708,""
NC,"04/01/2021",11985,907327,4781372,1768023,""
NC,"04/08/2021",10878,918205,5292280,2016649,""
NC,"04/15/2021",13725,931930,5936385,2416439,""
NC,"04/22/2021",13011,944941,6476136,2728719,""
NC,"04/29/2021",12345,957286,6888208,2961996,""
NC,"05/06/2021",10668,967954,7318598,3281376,""
NC,"05/13/2021",8357,976311,7609404,3491025,""
NC,"05/20/2021",6561,982872,7860387,3634090,""
NC,"05/27/2021",5588,988460,8063696,3739440,""
NC,"06/03/2021",3606,992066,8184505,3806938,""
NC,"06/10/2021",3107,995173,8324921,3900819,""
NC,"06/17/2021",2738,997911,8461283,4009503,""
NC,"06/24/2021",2675,1000586,8565156,4075959,""
NC,"07/01/2021",2809,1003395,9285070,4389800,""
NC,"07/08/2021",3535,1006930,9375785,4437638,""
NC,"07/15/2021",5761,1012691,9470597,4487926,""
NC,"07/22/2021",9233,1021924,9567516,4533215,""
NC,"07/29/2021",17200,1039124,9680714,4576966,""
NC,"08/05/2021",24763,1063887,9813347,4617619,""
NC,"08/12/2021",33104,1096991,9953649,4662804,""
NC,"08/19/2021",38426,1135417,10123499,4724100,""
NC,"08/26/2021",45457,1180874,10325611,4802652,0
NC,"09/02/2021",50082,1230956,10525501,4883485,0
NC,"09/09/2021",45209,1276165,10740910,4976852,0
NC,"09/16/2021",48519,1324684,10927893,5061424,0
NC,"09/23/2021",39054,1363738,11094325,5144085,0
NC,"09/30/2021",31244,1394982,11311513,5221411,0
NC,"10/07/2021",24561,1419543,11607374,5339892,0
NC,"10/14/2021",20615,1440158,11822237,5400818,0
NC,"10/21/2021",15701,1455859,12001934,5456338,241674
NC,"10/28/2021",13022,1468881,12251122,5504519,313122
NC,"11/04/2021",11390,1480271,12535459,5543800,422242
NC,"11/11/2021",11503,1491774,12813894,5594919,531320
NC,"11/18/2021",12812,1504586,13142848,5630586,629581
NC,"11/25/2021",13777,1518363,13378128,5660326,694024
NC,"12/02/2021",15473,1533836,13650328,5705077,795198
NC,"12/09/2021",21722,1555558,14020046,5790532,913846
NC,"12/16/2021",22640,1578198,14364927,5862248,1019278
NC,"12/23/2021",30459,1608657,14704019,5917873,1127859
NC,"12/30/2021",65563,1674220,14910025,5951239,1195062
NC,"01/06/2022",138516,1812736,15114964,5981568,1260220
NC,"01/13/2022",202667,2015403,15369073,6020048,1342862
NC,"01/20/2022",213266,2228669,15529382,6079388,1401317
NC,"01/27/2022",172345,2401014,15661336,6110114,1446760
NC,"02/03/2022",97954,2498968,15793856,6142826,1484140
NC,"02/10/2022",56009,2554977,15894297,6171328,1514323
NC,"02/17/2022",31938,2586915,16020472,6195236,1537830
NC,"02/24/2022",18535,2605450,16087180,6214836,1557466
NC,"03/03/2022",10925,2616375,16146189,6231369,1574890
NC,"03/10/2022",6117,2622492,16201828,6246270,1593926
NC,"03/17/2022",4083,2626575,16252421,6260694,1610273
NC,"03/24/2022",3549,2630124,16286180,6270013,1620470
NC,"03/31/2022",3884,2634008,16325759,6281123,1632686
NC,"04/07/2022",3767,2637775,16414398,6312294,1648409
NC,"04/14/2022",6358,2644133,16519054,6345927,1664562
NC,"04/21/2022",8573,2652706,16607004,6373960,1678246
NC,"04/28/2022",11818,2664524,16691599,6398376,1692228
NC,"05/05/2022",15101,2679625,16761585,6418966,1704021
NC,"05/12/2022",20041,2699666,16839752,6443951,1716040
NC,"05/19/2022",26531,2726197,16909798,6465387,1726982
NC,"05/26/2022",28794,2754991,16990012,6487547,1740775
NC,"06/02/2022",25502,2780493,17050085,6503645,1752770
NC,"06/09/2022",26781,2807274,17116132,6522153,1765132
NC,"06/16/2022",23254,2830528,17173974,6537109,1776704
ND,"12/17/2020",2538,88687,897,0,""
ND,"12/24/2020",2017,90704,8943,0,""
ND,"12/31/2020",1788,92492,15958,0,""
ND,"01/07/2021",1334,93826,27289,0,""
ND,"01/14/2021",1305,95131,42774,0,""
ND,"01/21/2021",1084,96215,59245,0,""
ND,"01/28/2021",932,97147,80051,0,""
ND,"02/04/2021",756,97903,106900,0,""
ND,"02/11/2021",335,98238,133616,0,""
ND,"02/18/2021",663,98901,156751,0,""
ND,"02/25/2021",626,99527,203911,0,""
ND,"03/04/2021",544,100071,246289,0,""
ND,"03/11/2021",546,100617,286495,96489,""
ND,"03/18/2021",666,101283,330516,117049,""
ND,"03/25/2021",714,101997,369029,132641,""
ND,"04/01/2021",1096,103093,419484,157052,""
ND,"04/08/2021",1075,104168,462999,182852,""
ND,"04/15/2021",1046,105214,504937,212728,""
ND,"04/22/2021",1005,106219,534462,231490,""
ND,"04/29/2021",934,107153,557851,247082,""
ND,"05/06/2021",927,108080,571481,255367,""
ND,"05/13/2021",679,108759,586153,264447,""
ND,"05/20/2021",603,109362,597686,270414,""
ND,"05/27/2021",416,109778,608339,275726,""
ND,"06/03/2021",264,110042,616200,279802,""
ND,"06/10/2021",254,110296,621981,283113,""
ND,"06/17/2021",191,110487,631234,289031,""
ND,"06/24/2021",119,110606,637216,292840,""
ND,"07/01/2021",97,110703,643108,296509,""
ND,"07/08/2021",72,110775,647362,298782,""
ND,"07/15/2021",151,110926,651359,300870,""
ND,"07/22/2021",165,111091,655153,302806,""
ND,"07/29/2021",318,111409,660913,304936,""
ND,"08/05/2021",523,111932,666987,306868,""
ND,"08/12/2021",811,112743,673739,308927,""
ND,"08/19/2021",1180,113923,681318,311604,""
ND,"08/26/2021",1743,115666,690359,315026,0
ND,"09/02/2021",2289,117955,700560,318810,0
ND,"09/09/2021",2647,120602,710545,322607,0
ND,"09/16/2021",3444,124046,721856,327120,0
ND,"09/23/2021",3237,127283,731561,331803,0
ND,"09/30/2021",4117,131400,742416,336457,0
ND,"10/07/2021",4332,135732,759219,340599,0
ND,"10/14/2021",3831,139563,775656,344203,0
ND,"10/21/2021",3424,142987,789310,347164,28630
ND,"10/28/2021",3400,146387,794566,348554,36014
ND,"11/04/2021",3470,149857,818204,363526,51546
ND,"11/11/2021",3568,153425,844222,366205,67884
ND,"11/18/2021",3315,156740,866939,368413,81135
ND,"11/25/2021",3104,159844,886167,370361,92747
ND,"12/02/2021",3134,162978,903605,373061,102143
ND,"12/09/2021",2866,165844,927047,377603,114612
ND,"12/16/2021",2405,168249,986040,395055,131289
ND,"12/23/2021",2124,170373,1002962,398412,140379
ND,"12/30/2021",2234,172607,1013290,400490,145325
ND,"01/06/2022",5204,177811,1024301,402983,150556
ND,"01/13/2022",9717,187528,1034859,405235,155668
ND,"01/20/2022",14806,202334,1042680,409283,159242
ND,"01/27/2022",14476,216810,1048391,410645,161791
ND,"02/03/2022",9932,226742,1052913,411708,163799
ND,"02/10/2022",5982,232724,1056286,412737,165131
ND,"02/17/2022",3139,235863,1061093,413827,165990
ND,"02/24/2022",1439,237302,1062988,414566,166586
ND,"03/03/2022",1015,238317,1064615,415178,167032
ND,"03/10/2022",567,238884,1065336,415495,167240
ND,"03/17/2022",408,239292,1066069,415798,167466
ND,"03/24/2022",145,239437,1066811,416107,167686
ND,"03/31/2022",230,239667,1067553,416375,167928
ND,"04/07/2022",190,239857,1068443,416660,168168
ND,"04/14/2022",247,240104,1070180,416991,168466
ND,"04/21/2022",273,240377,1071357,417886,168613
ND,"04/28/2022",333,240710,1073853,418277,168960
ND,"05/05/2022",414,241124,1107305,423802,181960
ND,"05/12/2022",611,241735,1110437,424243,182551
ND,"05/19/2022",723,242458,1113298,424681,183152
ND,"05/26/2022",882,243340,1116176,425005,183486
ND,"06/02/2022",935,244275,1119111,425401,184154
ND,"06/09/2022",1199,245474,1122929,425890,184991
ND,"06/16/2022",1069,246543,1126108,426275,185707
NE,"12/17/2020",8570,148818,1285,0,""
NE,"12/24/2020",7888,156706,15518,0,""
NE,"12/31/2020",5938,162644,27487,0,""
NE,"01/07/2021",7354,169998,53548,0,""
NE,"01/14/2021",6664,176662,91195,0,""
NE,"01/21/2021",5590,182252,111841,0,""
NE,"01/28/2021",4229,186481,150019,0,""
NE,"02/04/2021",3935,190416,195126,0,""
NE,"02/11/2021",2712,193128,247879,0,""
NE,"02/18/2021",2059,195187,305057,0,""
NE,"02/25/2021",2342,197529,422419,0,""
NE,"03/04/2021",2058,199587,513497,0,""
NE,"03/11/2021",2106,201693,629765,226435,""
NE,"03/18/2021",1911,203604,731885,276138,""
NE,"03/25/2021",1864,205468,836012,308676,""
NE,"04/01/2021",2461,207929,966534,373119,""
NE,"04/08/2021",2374,210303,1076467,426200,""
NE,"04/15/2021",2263,212566,1228445,508852,""
NE,"04/22/2021",2400,214966,1330661,567788,""
NE,"04/29/2021",1643,216609,1412743,626278,""
NE,"05/06/2021",1341,217950,1484345,681718,""
NE,"05/13/2021",1036,218986,1576707,749896,""
NE,"05/20/2021",548,219534,1627572,780411,""
NE,"05/27/2021",460,219994,1678518,806604,""
NE,"06/03/2021",331,220325,1706401,821358,""
NE,"06/10/2021",230,220555,1746606,846814,""
NE,"06/17/2021",212,220767,1780069,869763,""
NE,"06/24/2021",211,220978,1844039,908147,""
NE,"07/01/2021",337,221315,1868788,924490,""
NE,"07/08/2021",516,221831,1881129,931573,""
NE,"07/15/2021",602,222433,1893942,938466,""
NE,"07/22/2021",866,223299,1911245,946549,""
NE,"07/29/2021",1417,224716,1934576,955255,""
NE,"08/05/2021",2102,226818,1963126,964450,""
NE,"08/12/2021",2587,229405,1983371,971267,""
NE,"08/19/2021",3335,232740,2011896,982160,""
NE,"08/26/2021",4305,237045,2033359,991967,0
NE,"09/02/2021",5295,242340,2074696,1011269,0
NE,"09/09/2021",4969,247309,2095650,1022194,0
NE,"09/16/2021",5586,252895,2121935,1035755,0
NE,"09/23/2021",4904,257799,2144532,1047811,0
NE,"09/30/2021",4660,262459,2169872,1057562,0
NE,"10/07/2021",4270,266729,2208073,1065561,0
NE,"10/14/2021",4270,270999,2241341,1072367,0
NE,"10/21/2021",4008,275007,2276430,1079629,80464
NE,"10/28/2021",4484,279491,2318461,1085937,110059
NE,"11/04/2021",5125,284616,2364098,1090624,144824
NE,"11/11/2021",6246,290862,2432375,1097036,191722
NE,"11/18/2021",6165,297027,2500435,1102134,233027
NE,"11/25/2021",6569,303596,2557474,1106433,271127
NE,"12/02/2021",5958,309554,2617739,1115660,309498
NE,"12/09/2021",7458,317012,2696795,1130985,360398
NE,"12/16/2021",5991,323003,2755381,1142084,398332
NE,"12/23/2021",5571,328574,2815987,1151342,438420
NE,"12/30/2021",7488,336062,2856869,1157774,464103
NE,"01/06/2022",16135,352197,2894196,1164409,486094
NE,"01/13/2022",27745,379942,2935671,1170992,511854
NE,"01/20/2022",32573,412515,2972050,1182604,534362
NE,"01/27/2022",27338,439853,3000697,1188065,550682
NE,"02/03/2022",13619,453472,3018550,1192532,559775
NE,"02/10/2022",6565,460037,3039868,1198937,569383
NE,"02/17/2022",3493,463530,3064271,1203610,575704
NE,"02/24/2022",2121,465651,3076310,1207389,581009
NE,"03/03/2022",1227,466878,3086667,1210303,585237
NE,"03/10/2022",926,467804,3095065,1212894,588575
NE,"03/17/2022",582,468386,3101085,1214654,591133
NE,"03/24/2022",471,468857,3109028,1216730,594593
NE,"03/31/2022",418,469275,3134556,1221452,610697
NE,"04/07/2022",424,469699,3148207,1223486,613886
NE,"04/14/2022",516,470215,3166705,1225613,616717
NE,"04/21/2022",572,470787,3184254,1227585,619177
NE,"04/28/2022",785,471572,3201037,1229108,621280
NE,"05/05/2022",972,472544,3214182,1230463,623181
NE,"05/12/2022",1457,474001,3228840,1232096,625474
NE,"05/19/2022",1746,475747,3231455,1232505,625945
NE,"05/26/2022",1962,477709,3251305,1234372,629069
NE,"06/02/2022",2318,480027,3251401,1234488,629142
NE,"06/09/2022",2772,482799,3275244,1236790,634019
NE,"06/16/2022",2579,485378,3290082,1238135,637342
NH,"12/17/2020",5841,33433,1990,0,""
NH,"12/24/2020",5079,38512,9003,0,""
NH,"12/31/2020",4730,43242,25364,0,""
NH,"01/07/2021",5596,48838,42419,0,""
NH,"01/14/2021",5287,54125,60232,0,""
NH,"01/21/2021",5312,59437,80639,0,""
NH,"01/28/2021",4126,63563,110451,0,""
NH,"02/04/2021",3158,66721,145086,0,""
NH,"02/11/2021",2526,69247,184103,0,""
NH,"02/18/2021",2718,71965,226863,0,""
NH,"02/25/2021",2293,74258,291248,0,""
NH,"03/04/2021",1732,75990,349825,0,""
NH,"03/11/2021",1475,77465,418658,134741,""
NH,"03/18/2021",1902,79367,489626,167586,""
NH,"03/25/2021",2154,81521,566168,206493,""
NH,"04/01/2021",2655,84176,707655,247295,""
NH,"04/08/2021",2759,86935,858460,293087,""
NH,"04/15/2021",3048,89983,1050144,363308,""
NH,"04/22/2021",2412,92395,1117327,395833,""
NH,"04/29/2021",2010,94405,1138304,403679,""
NH,"05/06/2021",1476,95881,1159614,411500,""
NH,"05/13/2021",1212,97093,1201567,478289,""
NH,"05/20/2021",885,97978,1276034,517299,""
NH,"05/27/2021",492,98470,1375987,652539,""
NH,"06/03/2021",321,98791,1407303,675168,""
NH,"06/10/2021",205,98996,1457239,715515,""
NH,"06/17/2021",200,99196,1490887,738841,""
NH,"06/24/2021",170,99366,1501636,746481,""
NH,"07/01/2021",139,99505,1532741,762403,""
NH,"07/08/2021",146,99651,1556107,775779,""
NH,"07/15/2021",190,99841,1567201,781532,""
NH,"07/22/2021",231,100072,1577904,786808,""
NH,"07/29/2021",393,100465,1589310,791302,""
NH,"08/05/2021",812,101277,1600618,795440,""
NH,"08/12/2021",1076,102353,1613843,797825,""
NH,"08/19/2021",1636,103989,1628334,803304,""
NH,"08/26/2021",1894,105883,1677898,808675,0
NH,"09/02/2021",2138,108021,1687622,812490,0
NH,"09/09/2021",2235,110256,1707796,820746,0
NH,"09/16/2021",3035,113291,1723006,827369,0
NH,"09/23/2021",2666,115957,1734548,832472,0
NH,"09/30/2021",3763,119720,1753412,836277,0
NH,"10/07/2021",3214,122934,1781147,841449,0
NH,"10/14/2021",3839,126773,1847519,846029,0
NH,"10/21/2021",3842,130615,1871633,849952,11165
NH,"10/28/2021",1826,132441,1901441,853265,12768
NH,"11/04/2021",5337,137778,1952317,857767,22707
NH,"11/11/2021",4691,142469,1985217,862394,25541
NH,"11/18/2021",6249,148718,2050185,867827,40389
NH,"11/25/2021",6993,155711,2116124,878808,49884
NH,"12/02/2021",6872,162583,2148148,882647,52817
NH,"12/09/2021",8955,171538,2185778,888542,56394
NH,"12/16/2021",8700,180238,2275497,900601,87117
NH,"12/23/2021",8406,188644,2353556,909969,115677
NH,"12/30/2021",8012,196656,2387395,913328,125379
NH,"01/06/2022",11417,208073,2422037,916731,134631
NH,"01/13/2022",21300,229373,2468941,922250,148214
NH,"01/20/2022",22068,251441,2520057,929560,169502
NH,"01/27/2022",16359,267800,2550736,933708,177555
NH,"02/03/2022",10891,278691,2569883,936993,181993
NH,"02/10/2022",7172,285863,2592297,941572,189396
NH,"02/17/2022",5677,291540,2610598,945345,194749
NH,"02/24/2022",4161,295701,2627136,949182,199840
NH,"03/03/2022",3107,298808,2505874,942984,219058
NH,"03/10/2022",1065,299873,2557868,948862,246690
NH,"03/17/2022",820,300693,2542926,944492,284074
NH,"03/24/2022",841,301534,2342556,925389,304116
NH,"03/31/2022",849,302383,2472010,942592,380619
NH,"04/07/2022",158,302541,2491013,946010,386519
NH,"04/14/2022",2252,304793,2508940,949674,391167
NH,"04/21/2022",1931,306724,2508366,951790,416212
NH,"04/28/2022",2469,309193,2523139,954235,419790
NH,"05/05/2022",2968,312161,2545331,957467,427650
NH,"05/12/2022",3286,315447,2581028,961601,441816
NH,"05/19/2022",4454,319901,2589372,963088,443741
NH,"05/26/2022",3425,323326,2606421,965644,447982
NH,"06/02/2022",2507,325833,2619783,967430,451148
NH,"06/09/2022",1981,327814,2629673,969004,453722
NH,"06/16/2022",1416,329230,2633073,969705,454500
NJ,"12/17/2020",38077,456938,720,0,""
NJ,"12/24/2020",34403,491341,35473,0,""
NJ,"12/31/2020",31954,523295,78838,0,""
NJ,"01/07/2021",36762,560057,155458,0,""
NJ,"01/14/2021",42572,602629,294039,0,""
NJ,"01/21/2021",38511,641140,432220,0,""
NJ,"01/28/2021",35397,676537,648215,0,""
NJ,"02/04/2021",29270,705807,851721,0,""
NJ,"02/11/2021",26867,732674,1196677,0,""
NJ,"02/18/2021",22500,755174,1542174,0,""
NJ,"02/25/2021",20212,775386,1866378,0,""
NJ,"03/04/2021",24090,799476,2325257,0,""
NJ,"03/11/2021",23341,822817,2834934,998133,""
NJ,"03/18/2021",25910,848727,3346883,1197797,""
NJ,"03/25/2021",29209,877936,3869393,1405724,""
NJ,"04/01/2021",30880,908816,4523995,1730178,""
NJ,"04/08/2021",29163,937979,5226827,2077411,""
NJ,"04/15/2021",25505,963484,5978301,2494175,""
NJ,"04/22/2021",21219,984703,6605809,2811184,""
NJ,"04/29/2021",8420,993123,7217144,3150175,""
NJ,"05/06/2021",11197,1004320,7677602,3462111,""
NJ,"05/13/2021",4664,1008984,8156536,3796892,""
NJ,"05/20/2021",3181,1012165,8576106,4051601,""
NJ,"05/27/2021",2806,1014971,8944596,4256025,""
NJ,"06/03/2021",1795,1016766,9195623,4389480,""
NJ,"06/10/2021",1721,1018487,9438282,4543290,""
NJ,"06/17/2021",1839,1020326,9769651,4768442,""
NJ,"06/24/2021",1496,1021822,9999545,4908804,""
NJ,"07/01/2021",1595,1023417,9864834,4912136,""
NJ,"07/08/2021",1331,1024748,9976885,4976576,""
NJ,"07/15/2021",2266,1027014,10087454,5038105,""
NJ,"07/22/2021",3566,1030580,10197628,5096321,""
NJ,"07/29/2021",5395,1035975,10336670,5168253,""
NJ,"08/05/2021",7727,1043702,10462507,5220954,""
NJ,"08/12/2021",9696,1053398,10582372,5271010,""
NJ,"08/19/2021",12338,1065736,10738167,5336457,""
NJ,"08/26/2021",14164,1079900,10896325,5406935,0
NJ,"09/02/2021",14349,1094249,11050405,5479015,0
NJ,"09/09/2021",14042,1108291,11180372,5539830,0
NJ,"09/16/2021",15073,1123364,11320871,5609082,0
NJ,"09/23/2021",16003,1139367,11400181,5664242,0
NJ,"09/30/2021",12876,1152243,11535180,5713118,0
NJ,"10/07/2021",12135,1164378,11710176,5762084,0
NJ,"10/14/2021",11511,1175889,11854232,5802398,0
NJ,"10/21/2021",8506,1184395,12010472,5843217,346974
NJ,"10/28/2021",8806,1193201,12217932,5881358,471368
NJ,"11/04/2021",9050,1202251,12461932,5913305,631003
NJ,"11/11/2021",9172,1211423,12751789,5946177,804740
NJ,"11/18/2021",12032,1223455,13060893,5977160,972109
NJ,"11/25/2021",14904,1238359,13301118,5997187,1115616
NJ,"12/02/2021",17534,1255893,13599644,6043088,1286469
NJ,"12/09/2021",28032,1283925,13998467,6117660,1515582
NJ,"12/16/2021",32183,1316108,14351800,6183309,1733108
NJ,"12/23/2021",57104,1373212,14685687,6226479,1960177
NJ,"12/30/2021",122142,1495354,14946060,6261268,2114931
NJ,"01/06/2022",216384,1711738,15181675,6296483,2249884
NJ,"01/13/2022",203679,1915417,15465448,6343694,2412415
NJ,"01/20/2022",110199,2025616,15719685,6389434,2554813
NJ,"01/27/2022",59769,2085385,15934361,6429485,2669294
NJ,"02/03/2022",33913,2119298,16135931,6486751,2765732
NJ,"02/10/2022",17089,2136387,16286681,6530462,2837412
NJ,"02/17/2022",13964,2150351,16406772,6560847,2891618
NJ,"02/24/2022",10840,2161191,16506885,6584250,2945393
NJ,"03/03/2022",8870,2170061,16602533,6604997,2997813
NJ,"03/10/2022",7537,2177598,16662231,6621570,3025004
NJ,"03/17/2022",6642,2184240,16707522,6634523,3046417
NJ,"03/24/2022",6595,2190835,16751636,6645957,3066831
NJ,"03/31/2022",7504,2198339,16793453,6655799,3086322
NJ,"04/07/2022",9779,2208118,16908547,6673416,3112582
NJ,"04/14/2022",12940,2221058,17018970,6687832,3138193
NJ,"04/21/2022",13976,2235034,17108752,6700072,3158411
NJ,"04/28/2022",17010,2252044,17184061,6711405,3176204
NJ,"05/05/2022",21006,2273050,17268148,6722762,3194599
NJ,"05/12/2022",27357,2300407,17328463,6731670,3208937
NJ,"05/19/2022",34848,2335255,17423688,6744291,3230942
NJ,"05/26/2022",35253,2370508,17508820,6755204,3251752
NJ,"06/02/2022",27649,2398157,17564439,6762979,3267113
NJ,"06/09/2022",26449,2424606,17617311,6771202,3282547
NJ,"06/16/2022",20101,2444707,17666186,6779034,3297245
NM,"12/17/2020",11407,124357,309,0,""
NM,"12/24/2020",8885,133242,16012,0,""
NM,"12/31/2020",7944,141186,30528,0,""
NM,"01/07/2021",8798,149984,48303,0,""
NM,"01/14/2021",9135,159119,89415,0,""
NM,"01/21/2021",6716,165835,152465,0,""
NM,"01/28/2021",5212,171047,224692,0,""
NM,"02/04/2021",4605,175652,294566,0,""
NM,"02/11/2021",3138,178790,369864,0,""
NM,"02/18/2021",2542,181332,456034,0,""
NM,"02/25/2021",2447,183779,634845,0,""
NM,"03/04/2021",2118,185897,743904,0,""
NM,"03/11/2021",1589,187486,867690,316298,""
NM,"03/18/2021",1422,188908,1004050,378563,""
NM,"03/25/2021",1364,190272,1135178,440243,""
NM,"04/01/2021",1377,191649,1281047,503075,""
NM,"04/08/2021",1340,192989,1417243,570641,""
NM,"04/15/2021",1391,194380,1551199,640363,""
NM,"04/22/2021",1403,195783,1674797,704616,""
NM,"04/29/2021",1430,197213,1774298,764785,""
NM,"05/06/2021",1568,198781,1877127,835272,""
NM,"05/13/2021",1446,200227,1970066,902795,""
NM,"05/20/2021",1262,201489,2044921,948428,""
NM,"05/27/2021",1081,202570,2115055,985346,""
NM,"06/03/2021",652,203222,2160226,1009421,""
NM,"06/10/2021",603,203825,2196837,1032269,""
NM,"06/17/2021",645,204470,2262337,1076745,""
NM,"06/24/2021",661,205131,2310853,1108356,""
NM,"07/01/2021",413,205544,2384423,1145072,""
NM,"07/08/2021",452,205996,2409226,1160537,""
NM,"07/15/2021",850,206846,2431098,1173006,""
NM,"07/22/2021",1126,207972,2451920,1183675,""
NM,"07/29/2021",1712,209684,2472530,1192293,""
NM,"08/05/2021",2893,212577,2507037,1206469,""
NM,"08/12/2021",3917,216494,2536756,1217270,""
NM,"08/19/2021",5466,221960,2565472,1228094,""
NM,"08/26/2021",5676,227636,2611295,1246733,0
NM,"09/02/2021",5851,233487,2654443,1262474,0
NM,"09/09/2021",4943,238430,2684815,1277057,0
NM,"09/16/2021",4655,243085,2719164,1293631,0
NM,"09/23/2021",4268,247353,2750095,1310636,0
NM,"09/30/2021",4664,252017,2786048,1324646,0
NM,"10/07/2021",4931,256948,2829283,1334679,0
NM,"10/14/2021",5130,262078,2876311,1344070,0
NM,"10/21/2021",4699,266777,2924916,1352852,112765
NM,"10/28/2021",6078,272855,2800041,1299579,146809
NM,"11/04/2021",6815,279670,2865675,1306836,194076
NM,"11/11/2021",8887,288557,2934509,1314507,238735
NM,"11/18/2021",9756,298313,3014699,1321668,287553
NM,"11/25/2021",9778,308091,3091322,1328003,335171
NM,"12/02/2021",7998,316089,3151114,1336646,371999
NM,"12/09/2021",10624,326713,3236448,1353853,419890
NM,"12/16/2021",7611,334324,3324530,1370740,471593
NM,"12/23/2021",7186,341510,3403081,1382669,517982
NM,"12/30/2021",6321,347831,3441533,1389097,540174
NM,"01/06/2022",13798,361629,3472036,1395271,556854
NM,"01/13/2022",26496,388125,3532070,1405836,590628
NM,"01/20/2022",37795,425920,3590429,1422079,623747
NM,"01/27/2022",34142,460062,3633354,1429035,647059
NM,"02/03/2022",24392,484454,3666851,1436307,663782
NM,"02/10/2022",13116,497570,3697352,1443450,675061
NM,"02/17/2022",7794,505364,3735058,1451983,686379
NM,"02/24/2022",4340,509704,3757497,1458010,695573
NM,"03/03/2022",2844,512548,3774780,1462341,702187
NM,"03/10/2022",1963,514511,3789313,1466191,707943
NM,"03/17/2022",1307,515818,3800944,1469183,712443
NM,"03/24/2022",1038,516856,3812885,1472271,716874
NM,"03/31/2022",887,517743,3823262,1474951,720894
NM,"04/07/2022",961,518704,3845904,1478153,724857
NM,"04/14/2022",807,519511,3876227,1481735,729670
NM,"04/21/2022",1074,520585,3903147,1485617,733552
NM,"04/28/2022",1229,521814,3927993,1488965,737680
NM,"05/05/2022",1452,523266,3947180,1491565,741590
NM,"05/12/2022",1982,525248,3973633,1494796,745566
NM,"05/19/2022",2898,528146,3993689,1497370,748792
NM,"05/26/2022",4094,532240,4014677,1499885,752456
NM,"06/02/2022",4331,536571,4030140,1501981,755383
NM,"06/09/2022",6175,542746,4052898,1504662,760599
NM,"06/16/2022",6500,549246,4066113,1506364,763825
NV,"12/17/2020",17816,194098,694,0,""
NV,"12/24/2020",15864,209962,16149,0,""
NV,"12/31/2020",12633,222595,25645,0,""
NV,"01/07/2021",14798,237393,39761,0,""
NV,"01/14/2021",16592,253985,76844,0,""
NV,"01/21/2021",11158,265143,115991,0,""
NV,"01/28/2021",8730,273873,194942,0,""
NV,"02/04/2021",6834,280707,291601,0,""
NV,"02/11/2021",5088,285795,379077,0,""
NV,"02/18/2021",3597,289392,466981,0,""
NV,"02/25/2021",2667,292059,622189,0,""
NV,"03/04/2021",2625,294684,750160,0,""
NV,"03/11/2021",2463,297147,904504,316682,""
NV,"03/18/2021",2971,300118,1062287,378958,""
NV,"03/25/2021",1609,301727,1214518,433856,""
NV,"04/01/2021",2035,303762,1374197,501868,""
NV,"04/08/2021",2167,305929,1536848,586035,""
NV,"04/15/2021",3221,309150,1744896,694463,""
NV,"04/22/2021",2600,311750,1901548,776174,""
NV,"04/29/2021",2725,314475,2026997,841808,""
NV,"05/06/2021",2613,317088,2146595,922995,""
NV,"05/13/2021",2626,319714,2264766,1007414,""
NV,"05/20/2021",2002,321716,2374041,1062502,""
NV,"05/27/2021",1533,323249,2465315,1112760,""
NV,"06/03/2021",1432,324681,2525610,1145796,""
NV,"06/10/2021",1910,326591,2578580,1176814,""
NV,"06/17/2021",1603,328194,2657281,1226328,""
NV,"06/24/2021",2168,330362,2707121,1258761,""
NV,"07/01/2021",3350,333712,2783847,1295849,""
NV,"07/08/2021",2850,336562,2824487,1313510,""
NV,"07/15/2021",4731,341293,2861309,1328846,""
NV,"07/22/2021",5805,347098,2900886,1344053,""
NV,"07/29/2021",6645,353743,2947354,1360934,""
NV,"08/05/2021",7393,361136,3001625,1380831,""
NV,"08/12/2021",7478,368614,3050470,1400235,""
NV,"08/19/2021",7451,376065,3105565,1424847,""
NV,"08/26/2021",8051,384116,3164474,1452486,0
NV,"09/02/2021",7914,392030,3219810,1480400,0
NV,"09/09/2021",7175,399205,3262758,1501088,0
NV,"09/16/2021",8010,407215,3310452,1524348,0
NV,"09/23/2021",7106,414321,3353696,1546604,0
NV,"09/30/2021",5794,420115,3397599,1563310,0
NV,"10/07/2021",4809,424924,3453312,1579101,0
NV,"10/14/2021",4554,429478,3502073,1594245,0
NV,"10/21/2021",3952,433430,3549119,1608385,85899
NV,"10/28/2021",4022,437452,3612712,1625323,117473
NV,"11/04/2021",4303,441755,3685031,1638664,159751
NV,"11/11/2021",4530,446285,3762739,1651319,202670
NV,"11/18/2021",4349,450634,3842321,1662093,242346
NV,"11/25/2021",4092,454726,3908996,1670646,280372
NV,"12/02/2021",3342,458068,3988518,1684342,323350
NV,"12/09/2021",4420,462488,4075905,1700561,372684
NV,"12/16/2021",4360,466848,4165243,1716487,421667
NV,"12/23/2021",5522,472370,4248762,1728811,469540
NV,"12/30/2021",8960,481330,4314411,1738587,504492
NV,"01/06/2022",20644,501974,4379291,1749590,536764
NV,"01/13/2022",33742,535716,4454718,1762527,575753
NV,"01/20/2022",64152,599868,4517072,1784465,607137
NV,"01/27/2022",36833,636701,4565412,1794964,630374
NV,"02/03/2022",21270,657971,4604474,1806190,646703
NV,"02/10/2022",8869,666840,4637428,1816722,659568
NV,"02/17/2022",4496,671336,4681622,1829521,670600
NV,"02/24/2022",2176,673512,4702645,1835909,678775
NV,"03/03/2022",5493,679005,4719621,1841373,685029
NV,"03/10/2022",2297,681302,4745377,1846071,690082
NV,"03/17/2022",23146,704448,4766561,1849772,694756
NV,"03/24/2022",1147,705595,4778395,1852912,699394
NV,"03/31/2022",1159,706754,4788614,1855611,703289
NV,"04/07/2022",1212,707966,4814417,1859421,708122
NV,"04/14/2022",1140,709106,4842376,1863347,712709
NV,"04/21/2022",1234,710340,4867611,1868274,717127
NV,"04/28/2022",1940,712280,4888618,1871389,720822
NV,"05/05/2022",2431,714711,4909678,1874489,724843
NV,"05/12/2022",3183,717894,4927396,1877382,728449
NV,"05/19/2022",4365,722259,4946097,1879974,731913
NV,"05/26/2022",6190,728449,4965417,1882609,735777
NV,"06/02/2022",7182,735631,4982585,1885072,739375
NV,"06/09/2022",6744,742375,5000358,1887705,743308
NV,"06/16/2022",9129,751504,5016725,1889883,746785
NY,"12/17/2020",46707,438797,8514,0,""
NY,"12/24/2020",48265,487062,83557,0,""
NY,"12/31/2020",50310,537372,198125,0,""
NY,"01/07/2021",66198,603570,390597,0,""
NY,"01/14/2021",71135,674705,757466,0,""
NY,"01/21/2021",59198,733903,1116441,0,""
NY,"01/28/2021",50816,784719,1630504,0,""
NY,"02/04/2021",38343,823062,2060301,0,""
NY,"02/11/2021",31407,854469,2620734,0,""
NY,"02/18/2021",26475,880944,3253874,0,""
NY,"02/25/2021",22609,903553,3879303,0,""
NY,"03/04/2021",24388,927941,4730809,0,""
NY,"03/11/2021",23040,950981,5840907,1899848,""
NY,"03/18/2021",22893,973874,6853499,2260668,""
NY,"03/25/2021",24598,998472,7986362,2659823,""
NY,"04/01/2021",27874,1026346,9393484,3362056,""
NY,"04/08/2021",26539,1052885,11243192,4404749,""
NY,"04/15/2021",25464,1078349,12843875,5238268,""
NY,"04/22/2021",21167,1099516,14171716,5874354,""
NY,"04/29/2021",15086,1114602,15410701,6579272,""
NY,"05/06/2021",12406,1127008,16552492,7324286,""
NY,"05/13/2021",9389,1136397,17507860,8011020,""
NY,"05/20/2021",7294,1143691,18395906,8522398,""
NY,"05/27/2021",5112,1148803,19238158,8928854,""
NY,"06/03/2021",3000,1151803,19800697,9201500,""
NY,"06/10/2021",2244,1154047,20312650,9523380,""
NY,"06/17/2021",1479,1155526,21009772,9990196,""
NY,"06/24/2021",1063,1156589,21412026,10245202,""
NY,"07/01/2021",980,1157569,21851024,10541495,""
NY,"07/08/2021",1166,1158735,22108681,10692943,""
NY,"07/15/2021",1891,1160626,22359206,10830744,""
NY,"07/22/2021",3094,1163720,22600802,10954046,""
NY,"07/29/2021",5288,1169008,22860905,11073293,""
NY,"08/05/2021",9079,1178087,23142420,11185892,""
NY,"08/12/2021",13268,1191355,23446958,11294591,""
NY,"08/19/2021",16340,1207695,23775447,11430449,""
NY,"08/26/2021",17406,1225101,24112728,11575526,0
NY,"09/02/2021",21074,1246175,24491810,11754776,0
NY,"09/09/2021",20461,1266636,24829216,11910624,0
NY,"09/16/2021",22877,1289513,25195859,12082430,0
NY,"09/23/2021",24165,1313678,25547966,12254270,0
NY,"09/30/2021",23888,1337566,25924474,12402027,0
NY,"10/07/2021",22867,1360433,26295456,12530826,0
NY,"10/14/2021",23289,1383722,26528501,12599760,0
NY,"10/21/2021",22528,1406250,27013498,12807398,482616
NY,"10/28/2021",19023,1425273,27387977,12924107,638233
NY,"11/04/2021",21024,1446297,27838699,13025675,867282
NY,"11/11/2021",25202,1471499,28299124,13115096,1112036
NY,"11/18/2021",32013,1503512,28895991,13198426,1414902
NY,"11/25/2021",37514,1541026,29477691,13268116,1745546
NY,"12/02/2021",36257,1577283,30151123,13361820,2122521
NY,"12/09/2021",51116,1628399,31056954,13513005,2630084
NY,"12/16/2021",49667,1678066,32675432,13763273,3623388
NY,"12/23/2021",69461,1747527,33578073,13874220,4159603
NY,"12/30/2021",113651,1861178,34256514,13961789,4543102
NY,"01/06/2022",206354,2067532,34834997,14048735,4862474
NY,"01/13/2022",226479,2294011,35475047,14162994,5214662
NY,"01/20/2022",140484,2434495,36034355,14276689,5522564
NY,"01/27/2022",83440,2517935,36493079,14373799,5764467
NY,"02/03/2022",47438,2565373,36851143,14459490,5943465
NY,"02/10/2022",28720,2594093,37159154,14541882,6090653
NY,"02/17/2022",18074,2612167,37467866,14611622,6242095
NY,"02/24/2022",12540,2624707,37747898,14667298,6397314
NY,"03/03/2022",8528,2633235,37932511,14709484,6486896
NY,"03/10/2022",7598,2640833,38051819,14743692,6535874
NY,"03/17/2022",7354,2648187,38144703,14771307,6572786
NY,"03/24/2022",9311,2657498,38238797,14796634,6611945
NY,"03/31/2022",11696,2669194,38328575,14818932,6648048
NY,"04/07/2022",15088,2684282,38542854,14854261,6690728
NY,"04/14/2022",22279,2706561,38786524,14891017,6732384
NY,"04/21/2022",26315,2732876,38991309,14920882,6768929
NY,"04/28/2022",30063,2762939,39184813,14949546,6802166
NY,"05/05/2022",34718,2797657,39349891,14975163,6831804
NY,"05/12/2022",40109,2837766,39505025,15000019,6859827
NY,"05/19/2022",40665,2878431,39659855,15024474,6888280
NY,"05/26/2022",33374,2911805,39812488,15048453,6919017
NY,"06/02/2022",22935,2934740,39933899,15067371,6946375
NY,"06/09/2022",19777,2954517,40017065,15082932,6966540
NY,"06/16/2022",15417,2969934,40151915,15105604,6998770
OH,"12/17/2020",64658,584770,511,0,""
OH,"12/24/2020",60052,644822,11702,0,""
OH,"12/31/2020",45926,690748,94126,0,""
OH,"01/07/2021",52069,742817,175681,0,""
OH,"01/14/2021",56822,799639,348424,0,""
OH,"01/21/2021",42794,842433,487481,0,""
OH,"01/28/2021",35851,878284,789869,0,""
OH,"02/04/2021",28443,906727,1128082,0,""
OH,"02/11/2021",21904,928631,1459174,0,""
OH,"02/18/2021",16459,945090,1861434,0,""
OH,"02/25/2021",14917,960007,2351582,0,""
OH,"03/04/2021",12598,972605,2850454,0,""
OH,"03/11/2021",10883,983488,3391091,1242387,""
OH,"03/18/2021",10193,993681,4018634,1503314,""
OH,"03/25/2021",10989,1004670,4679419,1722559,""
OH,"04/01/2021",12895,1017565,5400664,2011920,""
OH,"04/08/2021",13299,1030864,6157849,2355045,""
OH,"04/15/2021",15081,1045945,6959193,2839225,""
OH,"04/22/2021",12452,1058397,7654474,3281245,""
OH,"04/29/2021",10588,1068985,8255989,3694410,""
OH,"05/06/2021",9749,1078734,8690074,3990903,""
OH,"05/13/2021",8448,1087182,9123816,4303920,""
OH,"05/20/2021",6354,1093536,9452028,4482000,""
OH,"05/27/2021",6044,1099580,9771216,4631720,""
OH,"06/03/2021",3305,1102885,9953378,4728941,""
OH,"06/10/2021",2832,1105717,10183481,4873645,""
OH,"06/17/2021",2183,1107900,10404025,5032428,""
OH,"06/24/2021",1801,1109701,10557313,5135111,""
OH,"07/01/2021",1624,1111325,10703193,5238887,""
OH,"07/08/2021",1683,1113008,10791040,5292838,""
OH,"07/15/2021",2237,1115245,10862282,5333537,""
OH,"07/22/2021",4053,1119298,10952659,5378842,""
OH,"07/29/2021",6123,1125421,11028431,5409293,""
OH,"08/05/2021",9544,1134965,11158070,5464123,""
OH,"08/12/2021",14353,1149318,11268911,5503962,""
OH,"08/19/2021",18793,1168111,11398472,5556220,""
OH,"08/26/2021",24367,1192478,11532916,5613080,0
OH,"09/02/2021",35524,1228002,11654346,5667784,0
OH,"09/09/2021",40839,1268841,11777029,5722961,0
OH,"09/16/2021",50424,1319265,11830706,5767541,0
OH,"09/23/2021",46535,1365800,11937353,5818486,0
OH,"09/30/2021",41642,1407442,12089450,5870552,0
OH,"10/07/2021",38343,1445785,12300302,5923087,0
OH,"10/14/2021",34586,1480371,12455850,5964942,0
OH,"10/21/2021",27305,1507676,12644571,6008452,401956
OH,"10/28/2021",24139,1531815,12861705,6046207,549491
OH,"11/04/2021",24393,1556208,13193595,6079963,799737
OH,"11/11/2021",29590,1585798,13535595,6115880,1040232
OH,"11/18/2021",34638,1620436,13873903,6148754,1256850
OH,"11/25/2021",39695,1660131,14192281,6175735,1470726
OH,"12/02/2021",39030,1699161,14521898,6224765,1690270
OH,"12/09/2021",53347,1752508,14934121,6309251,1960242
OH,"12/16/2021",55031,1807539,15319804,6381746,2218858
OH,"12/23/2021",73049,1880588,15679874,6425443,2475592
OH,"12/30/2021",95135,1975723,15926401,6457896,2647880
OH,"01/06/2022",137101,2112824,16181328,6494339,2815893
OH,"01/13/2022",134150,2246974,16459851,6535591,2996996
OH,"01/20/2022",192231,2439205,16673418,6582685,3132386
OH,"01/27/2022",101659,2540864,16838849,6618742,3226215
OH,"02/03/2022",54640,2595504,16960842,6653301,3287733
OH,"02/10/2022",25878,2621382,17031220,6678306,3318161
OH,"02/17/2022",16820,2638202,17126534,6704695,3351128
OH,"02/24/2022",10176,2648378,17195084,6724932,3380834
OH,"03/03/2022",7786,2656164,17250407,6740261,3404743
OH,"03/10/2022",5393,2661557,17297241,6753624,3425146
OH,"03/17/2022",2278,2663835,17337160,6765792,3441841
OH,"03/24/2022",2195,2666030,17375094,6775887,3458687
OH,"03/31/2022",3664,2669694,17410001,6784882,3473902
OH,"04/07/2022",3092,2672786,17505033,6794478,3492678
OH,"04/14/2022",3833,2676619,17613950,6804018,3509597
OH,"04/21/2022",4818,2681437,17711985,6812411,3525885
OH,"04/28/2022",6889,2688326,17804440,6820544,3542660
OH,"05/05/2022",8732,2697058,17888231,6828875,3556920
OH,"05/12/2022",11013,2708071,18037856,6874625,3589426
OH,"05/19/2022",15970,2724041,18116382,6881740,3602365
OH,"05/26/2022",19536,2743577,18209402,6891791,3619178
OH,"06/02/2022",19546,2763123,18274712,6897523,3632058
OH,"06/09/2022",17530,2780653,18234848,6860079,3633153
OH,"06/16/2022",18247,2798900,18279491,6865123,3643713
OK,"12/17/2020",22279,245272,2257,0,""
OK,"12/24/2020",24145,269417,26553,0,""
OK,"12/31/2020",17877,287294,46609,0,""
OK,"01/07/2021",24630,311924,85850,0,""
OK,"01/14/2021",29897,341821,187707,0,""
OK,"01/21/2021",19091,360912,267434,0,""
OK,"01/28/2021",18877,379789,363253,0,""
OK,"02/04/2021",15273,395062,484384,0,""
OK,"02/11/2021",13530,408592,628361,0,""
OK,"02/18/2021",8214,416806,700440,0,""
OK,"02/25/2021",5233,422039,967522,0,""
OK,"03/04/2021",4783,426822,1181414,0,""
OK,"03/11/2021",4575,431397,1364914,486421,""
OK,"03/18/2021",3348,434745,1551665,541818,""
OK,"03/25/2021",2694,437439,1753658,619062,""
OK,"04/01/2021",2298,439737,1975056,730894,""
OK,"04/08/2021",2168,441905,2198505,855150,""
OK,"04/15/2021",2319,444224,2385570,974991,""
OK,"04/22/2021",1734,445958,2546118,1078042,""
OK,"04/29/2021",1676,447634,2666794,1162129,""
OK,"05/06/2021",1626,449260,2750458,1218612,""
OK,"05/13/2021",1278,450538,2815020,1260212,""
OK,"05/20/2021",931,451469,2879476,1295357,""
OK,"05/27/2021",1024,452493,2931855,1321137,""
OK,"06/03/2021",788,453281,2968699,1340489,""
OK,"06/10/2021",810,454091,3011989,1365242,""
OK,"06/17/2021",1052,455143,3152269,1447908,""
OK,"06/24/2021",1269,456412,3211318,1484533,""
OK,"07/01/2021",1438,457850,3274030,1522466,""
OK,"07/08/2021",1825,459675,3304376,1538148,""
OK,"07/15/2021",3477,463152,3342584,1555049,""
OK,"07/22/2021",5249,468401,3385533,1571398,""
OK,"07/29/2021",8651,477052,3440451,1587380,""
OK,"08/05/2021",12286,489338,3505038,1606041,""
OK,"08/12/2021",14214,503552,3575444,1628253,""
OK,"08/19/2021",15471,519023,3656032,1659663,""
OK,"08/26/2021",15899,534922,3764132,1705301,0
OK,"09/02/2021",19574,554496,3859158,1747709,0
OK,"09/09/2021",17727,572223,3934897,1781639,0
OK,"09/16/2021",15464,587687,4013260,1820228,0
OK,"09/23/2021",13113,600800,4080662,1855558,0
OK,"09/30/2021",11085,611885,4152019,1883414,0
OK,"10/07/2021",8949,620834,4233576,1907781,0
OK,"10/14/2021",8678,629512,4304068,1929976,0
OK,"10/21/2021",7248,636760,4366147,1948583,144370
OK,"10/28/2021",5602,642362,4448436,1972206,187657
OK,"11/04/2021",4401,646763,4544659,1990041,240753
OK,"11/11/2021",3926,650689,4639425,2006541,288861
OK,"11/18/2021",5885,656574,4737575,2019331,332571
OK,"11/25/2021",5646,662220,4822388,2030324,375847
OK,"12/02/2021",5292,667512,4913912,2046492,421968
OK,"12/09/2021",9378,676890,5032999,2069094,483971
OK,"12/16/2021",7689,684579,5135841,2089044,538287
OK,"12/23/2021",6703,691282,5237461,2104605,593768
OK,"12/30/2021",9516,700798,5308000,2116382,629469
OK,"01/06/2022",24077,724875,5376180,2128398,661725
OK,"01/13/2022",50294,775169,5456845,2141228,700602
OK,"01/20/2022",77828,852997,5523657,2163793,732355
OK,"01/27/2022",78036,931033,5579417,2176078,756239
OK,"02/03/2022",52904,983937,5620501,2187212,773348
OK,"02/10/2022",16543,1000480,5643518,2195436,781502
OK,"02/17/2022",10056,1010536,5690268,2206921,791737
OK,"02/24/2022",6403,1016939,5713651,2214720,799948
OK,"03/03/2022",5805,1022744,5727694,2219248,805092
OK,"03/10/2022",1705,1024449,5745840,2225298,811762
OK,"03/17/2022",2155,1026604,5756328,2229014,815295
OK,"03/24/2022",2958,1029562,5774857,2234691,822111
OK,"03/31/2022",1806,1031368,5788524,2238842,826851
OK,"04/07/2022",1827,1033195,5818315,2245338,832508
OK,"04/14/2022",2055,1035250,5851073,2252128,837605
OK,"04/21/2022",1188,1036438,5880521,2257992,842980
OK,"04/28/2022",1758,1038196,5904620,2262941,847050
OK,"05/05/2022",1747,1039943,5925949,2267459,851026
OK,"05/12/2022",1448,1041391,5945239,2271666,854648
OK,"05/19/2022",2137,1043528,5964852,2275632,858158
OK,"05/26/2022",2037,1045565,5985377,2279402,862200
OK,"06/02/2022",2448,1048013,6001118,2282366,865482
OK,"06/09/2022",3056,1051069,6017829,2285577,869154
OK,"06/16/2022",3884,1054953,6030308,2288009,871757
OR,"12/17/2020",9334,97621,198,0,""
OR,"12/24/2020",8350,105971,10409,0,""
OR,"12/31/2020",6289,112260,31386,0,""
OR,"01/07/2021",7963,120223,61672,0,""
OR,"01/14/2021",8886,129109,129796,0,""
OR,"01/21/2021",6034,135143,216928,0,""
OR,"01/28/2021",4920,140063,340383,0,""
OR,"02/04/2021",4542,144605,471983,0,""
OR,"02/11/2021",3870,148475,589035,0,""
OR,"02/18/2021",2782,151257,708570,0,""
OR,"02/25/2021",2801,154058,889531,0,""
OR,"03/04/2021",2230,156288,1073041,0,""
OR,"03/11/2021",2003,158291,1239800,448006,""
OR,"03/18/2021",1997,160288,1433105,529551,""
OR,"03/25/2021",2095,162383,1657083,618399,""
OR,"04/01/2021",2629,165012,1893672,720833,""
OR,"04/08/2021",3116,168128,2160491,844551,""
OR,"04/15/2021",4078,172206,2455797,988029,""
OR,"04/22/2021",4928,177134,2681488,1093608,""
OR,"04/29/2021",5782,182916,3007184,1264674,""
OR,"05/06/2021",5501,188417,3239343,1391319,""
OR,"05/13/2021",4597,193014,3525900,1572905,""
OR,"05/20/2021",3773,196787,3735151,1701973,""
OR,"05/27/2021",2997,199784,3962890,1841255,""
OR,"06/03/2021",2210,201994,4102583,1934265,""
OR,"06/10/2021",1939,203933,4232089,2023687,""
OR,"06/17/2021",1765,205698,4389478,2138497,""
OR,"06/24/2021",1635,207333,4463557,2190389,""
OR,"07/01/2021",1308,208641,4576887,2268409,""
OR,"07/08/2021",1123,209764,4622951,2296413,""
OR,"07/15/2021",1552,211316,4657136,2317504,""
OR,"07/22/2021",2413,213729,4686979,2334660,""
OR,"07/29/2021",3960,217689,4729527,2355462,""
OR,"08/05/2021",6858,224547,4770100,2371953,""
OR,"08/12/2021",9846,234393,4812087,2388289,""
OR,"08/19/2021",13473,247866,4863386,2407739,""
OR,"08/26/2021",15298,263164,4926367,2431029,0
OR,"09/02/2021",15923,279087,4982271,2452534,0
OR,"09/09/2021",12891,291978,5050384,2480268,0
OR,"09/16/2021",13582,305560,5115606,2509998,0
OR,"09/23/2021",11547,317107,5173200,2537156,0
OR,"09/30/2021",11077,328184,5233207,2562913,0
OR,"10/07/2021",9947,338131,5322063,2588568,0
OR,"10/14/2021",8353,346484,5407865,2610017,0
OR,"10/21/2021",8192,354676,5482628,2627410,185723
OR,"10/28/2021",7884,362560,5579756,2644914,250258
OR,"11/04/2021",7257,369817,5709574,2659458,347785
OR,"11/11/2021",6556,376373,5836336,2671231,438909
OR,"11/18/2021",5469,381842,5977918,2681377,520375
OR,"11/25/2021",5643,387485,6122487,2692675,617395
OR,"12/02/2021",4712,392197,6243406,2705818,699862
OR,"12/09/2021",6065,398262,6416184,2741830,808049
OR,"12/16/2021",5066,403328,6584937,2772475,918663
OR,"12/23/2021",5921,409249,6750694,2793662,1034832
OR,"12/30/2021",9084,418333,6831952,2802741,1092640
OR,"01/06/2022",23315,441648,6890513,2810968,1132348
OR,"01/13/2022",53298,494946,7012272,2827692,1215558
OR,"01/20/2022",54996,549942,7126698,2844720,1294457
OR,"01/27/2022",55421,605363,7224660,2855272,1360233
OR,"02/03/2022",38610,643973,7297503,2866271,1405765
OR,"02/10/2022",24809,668782,7346463,2875544,1435136
OR,"02/17/2022",13783,682565,7393063,2885515,1459363
OR,"02/24/2022",7915,690480,7424941,2892814,1475387
OR,"03/03/2022",4842,695322,7458472,2899766,1492623
OR,"03/10/2022",3171,698493,7479579,2904737,1503077
OR,"03/17/2022",2162,700655,7502272,2909788,1513768
OR,"03/24/2022",1629,702284,7520565,2913516,1522775
OR,"03/31/2022",1555,703839,7537264,2916841,1530825
OR,"04/07/2022",1977,705816,7585681,2921261,1539005
OR,"04/14/2022",2705,708521,7648067,2926148,1547125
OR,"04/21/2022",4164,712685,7706043,2930493,1555180
OR,"04/28/2022",5945,718630,7758370,2934467,1562971
OR,"05/05/2022",7981,726611,7813801,2938768,1571890
OR,"05/12/2022",8853,735464,7858378,2942509,1579591
OR,"05/19/2022",10259,745723,7900992,2945996,1586521
OR,"05/26/2022",11486,757209,7943758,2949465,1594773
OR,"06/02/2022",10076,767285,7979350,2952457,1603197
OR,"06/09/2022",10414,777699,8012524,2955467,1611373
OR,"06/16/2022",10428,788127,8043434,2958269,1619474
PA,"12/17/2020",74405,527869,1681,0,""
PA,"12/24/2020",61842,589711,74228,0,""
PA,"12/31/2020",50428,640139,143381,0,""
PA,"01/07/2021",51939,692078,202498,0,""
PA,"01/14/2021",58068,750146,448151,0,""
PA,"01/21/2021",41256,791402,605428,0,""
PA,"01/28/2021",35414,826816,856371,0,""
PA,"02/04/2021",35126,861942,1218735,0,""
PA,"02/11/2021",26878,888820,1594474,0,""
PA,"02/18/2021",21715,910535,2002786,0,""
PA,"02/25/2021",18033,928568,2489919,0,""
PA,"03/04/2021",18149,946717,3036398,0,""
PA,"03/11/2021",17535,964252,3737143,1203908,""
PA,"03/18/2021",18663,982915,4591687,1580677,""
PA,"03/25/2021",23356,1006271,5325139,1843196,""
PA,"04/01/2021",29013,1035284,6201769,2197732,""
PA,"04/08/2021",30049,1065333,6842553,2479698,""
PA,"04/15/2021",34001,1099334,8084439,3120764,""
PA,"04/22/2021",30784,1130118,9007319,3566747,""
PA,"04/29/2021",24820,1154938,9931324,4027307,""
PA,"05/06/2021",21629,1176567,10644951,4433300,""
PA,"05/13/2021",15290,1191857,11288966,4842853,""
PA,"05/20/2021",11108,1202965,11872222,5183394,""
PA,"05/27/2021",8817,1211782,12369985,5462969,""
PA,"06/03/2021",5151,1216933,12677443,5633265,""
PA,"06/10/2021",3871,1220804,13084043,5878170,""
PA,"06/17/2021",2564,1223368,13479483,6117497,""
PA,"06/24/2021",1658,1225026,13715484,6256420,""
PA,"07/01/2021",1268,1226294,13914074,6368540,""
PA,"07/08/2021",1187,1227481,14066966,6453512,""
PA,"07/15/2021",1798,1229279,14199798,6525132,""
PA,"07/22/2021",3084,1232363,14350596,6601178,""
PA,"07/29/2021",4846,1237209,14520961,6681441,""
PA,"08/05/2021",8251,1245460,14692536,6754834,""
PA,"08/12/2021",11752,1257212,14868761,6826472,""
PA,"08/19/2021",14959,1272171,15051404,6904640,""
PA,"08/26/2021",20063,1292234,15253030,6989211,0
PA,"09/02/2021",23712,1315946,15473377,7087237,0
PA,"09/09/2021",25411,1341357,15642841,7164447,0
PA,"09/16/2021",30622,1371979,15838570,7255560,0
PA,"09/23/2021",33880,1405859,16014184,7339324,0
PA,"09/30/2021",33536,1439395,16205819,7405158,0
PA,"10/07/2021",34007,1473402,16485841,7478873,0
PA,"10/14/2021",33493,1506895,16766705,7552044,0
PA,"10/21/2021",30628,1537523,17099948,7661645,294836
PA,"10/28/2021",27670,1565193,17447607,7724871,412358
PA,"11/04/2021",26985,1592178,17867712,7785241,571018
PA,"11/11/2021",31608,1623786,18388267,7864190,754329
PA,"11/18/2021",37486,1661272,18846817,7918276,899110
PA,"11/25/2021",44462,1705734,18031448,7430988,943177
PA,"12/02/2021",40054,1745788,18442499,7513481,1128454
PA,"12/09/2021",54636,1800424,18887180,7626577,1325136
PA,"12/16/2021",57865,1858289,19371479,7741532,1548332
PA,"12/23/2021",56453,1914742,19797910,8126163,2465100
PA,"12/30/2021",80353,1995095,20120946,8174643,2617172
PA,"01/06/2022",154786,2149881,20403513,8221488,2747303
PA,"01/13/2022",201172,2351053,20775704,8284852,2917775
PA,"01/20/2022",156708,2507761,21221427,8344473,3195026
PA,"01/27/2022",99143,2606904,21469741,8394026,3302338
PA,"02/03/2022",68884,2675788,21658568,8443447,3376414
PA,"02/10/2022",34456,2710244,21791772,8484950,3424954
PA,"02/17/2022",22556,2732800,21931430,8525362,3471733
PA,"02/24/2022",16562,2749362,22046766,8559178,3511486
PA,"03/03/2022",9935,2759297,22146157,8592083,3546683
PA,"03/10/2022",6906,2766203,22192408,8606988,3562405
PA,"03/17/2022",5466,2771669,22252378,8624090,3582720
PA,"03/24/2022",4241,2775910,22314165,8640788,3605549
PA,"03/31/2022",4326,2780236,22367634,8653952,3624165
PA,"04/07/2022",4857,2785093,22446301,8678318,3648557
PA,"04/14/2022",6984,2792077,22539547,8704752,3677186
PA,"04/21/2022",9445,2801522,22612059,8726883,3698298
PA,"04/28/2022",11301,2812823,22921284,8745999,3722234
PA,"05/05/2022",15004,2827827,23065417,8771422,3745084
PA,"05/12/2022",22026,2849853,23179385,8791408,3764129
PA,"05/19/2022",27763,2877616,23294518,8811712,3783186
PA,"05/26/2022",30637,2908253,23415953,8831800,3805033
PA,"06/02/2022",24341,2932594,23515547,8849146,3825986
PA,"06/09/2022",22212,2954806,23600305,8863888,3843689
PA,"06/16/2022",17476,2972282,23703213,8880605,3865803
PR,"12/17/2020",4724,63686,2129,0,""
PR,"12/24/2020",7122,70808,17042,0,""
PR,"12/31/2020",5483,76291,35300,0,""
PR,"01/07/2021",3612,79903,51428,0,""
PR,"01/14/2021",4913,84816,94880,0,""
PR,"01/21/2021",3912,88728,147795,0,""
PR,"01/28/2021",3813,92541,212179,0,""
PR,"02/04/2021",2443,94984,278321,0,""
PR,"02/11/2021",1652,96636,336959,0,""
PR,"02/18/2021",1872,98508,408058,0,""
PR,"02/25/2021",1112,99620,510041,0,""
PR,"03/04/2021",1247,100867,595224,0,""
PR,"03/11/2021",1187,102054,675568,249152,""
PR,"03/18/2021",1293,103347,814157,304183,""
PR,"03/25/2021",1621,104968,952499,351547,""
PR,"04/01/2021",2503,107471,1114680,415027,""
PR,"04/08/2021",3208,110679,1225223,464881,""
PR,"04/15/2021",7157,117836,1468663,576945,""
PR,"04/22/2021",7376,125212,1653249,671118,""
PR,"04/29/2021",5459,130671,1850881,760772,""
PR,"05/06/2021",3177,133848,2042436,852404,""
PR,"05/13/2021",2023,135871,2265054,951310,""
PR,"05/20/2021",1282,137153,2432019,1043268,""
PR,"05/27/2021",1061,138214,2631756,1145271,""
PR,"06/03/2021",584,138798,2740718,1204529,""
PR,"06/10/2021",391,139189,2861256,1272298,""
PR,"06/17/2021",301,139490,2973092,1339907,""
PR,"06/24/2021",311,139801,3078320,1399749,""
PR,"07/01/2021",254,140055,3696501,1759206,""
PR,"07/08/2021",378,140433,3790497,1813973,""
PR,"07/15/2021",666,141099,3863437,1855232,""
PR,"07/22/2021",1259,142358,3933973,1890009,""
PR,"07/29/2021",2604,144962,3964947,1905873,""
PR,"08/05/2021",4395,149357,3997166,1923313,""
PR,"08/12/2021",5200,154557,4047486,1946164,""
PR,"08/19/2021",5306,159863,4113335,1967753,""
PR,"08/26/2021",7209,167072,4179097,1989764,0
PR,"09/02/2021",4483,171555,4271096,2024176,0
PR,"09/09/2021",3619,175174,4378233,2075828,0
PR,"09/16/2021",2812,177986,4508458,2152960,0
PR,"09/23/2021",1765,179751,4610741,2210865,0
PR,"09/30/2021",1436,181187,4673227,2245195,0
PR,"10/07/2021",1391,182578,4750762,2278170,0
PR,"10/14/2021",799,183377,4809505,2296127,0
PR,"10/21/2021",804,184181,4926629,2332873,106462
PR,"10/28/2021",697,184878,4972903,2341967,135101
PR,"11/04/2021",711,185589,5065395,2354881,197181
PR,"11/11/2021",869,186458,5154324,2364113,258644
PR,"11/18/2021",747,187205,5255755,2373332,318213
PR,"11/25/2021",810,188015,5335589,2361160,366414
PR,"12/02/2021",591,188606,5441246,2370938,431780
PR,"12/09/2021",889,189495,5566601,2394634,503710
PR,"12/16/2021",774,190269,5719920,2431387,576526
PR,"12/23/2021",12481,202750,5837118,2448200,648501
PR,"12/30/2021",40867,243617,5916216,2459031,698429
PR,"01/06/2022",69565,313182,6003460,2470666,754932
PR,"01/13/2022",60923,374105,6097470,2482541,817536
PR,"01/20/2022",49550,423655,6237152,2507498,898541
PR,"01/27/2022",25317,448972,6344409,2519295,975570
PR,"02/03/2022",10666,459638,6574594,2545416,1131193
PR,"02/10/2022",6606,466244,6687811,2560558,1210079
PR,"02/17/2022",3936,470180,6819899,2581720,1289453
PR,"02/24/2022",2360,472540,6895718,2594790,1341616
PR,"03/03/2022",1603,474143,6943919,2603231,1373764
PR,"03/10/2022",1669,475812,6994077,2611538,1407390
PR,"03/17/2022",1036,476848,7027871,2614969,1432708
PR,"03/24/2022",1625,478473,7048803,2618468,1446545
PR,"03/31/2022",2042,480515,7083170,2624435,1466000
PR,"04/07/2022",3091,483606,7050520,2638902,1514178
PR,"04/14/2022",6047,489653,7083515,2643014,1524105
PR,"04/21/2022",10320,499973,7109192,2645701,1529640
PR,"04/28/2022",22887,522860,7135080,2648297,1535590
PR,"05/05/2022",27806,550666,7182147,2653070,1546861
PR,"05/12/2022",31550,582216,7211476,2656684,1554140
PR,"05/19/2022",38481,620697,7242205,2659648,1561829
PR,"05/26/2022",26444,647141,7268719,2661836,1567501
PR,"06/02/2022",25766,672907,7291508,2663743,1572668
PR,"06/09/2022",26664,699571,7316555,2665795,1579002
PR,"06/16/2022",24261,723832,7333703,2667387,1583780
PW,"02/03/2022",1217,2118,44760,17259,10236
PW,"02/10/2022",841,2959,45645,17554,10653
PW,"02/17/2022",466,3425,45805,17590,10757
PW,"02/24/2022",271,3696,46408,17826,11010
PW,"03/03/2022",127,3823,46606,17899,11079
PW,"03/10/2022",65,3888,46730,17962,11120
PW,"03/17/2022",47,3935,46929,18002,11225
PW,"03/24/2022",41,3976,47001,18047,11244
PW,"03/31/2022",48,4024,47052,18070,11261
PW,"04/07/2022",46,4070,47139,18101,11293
PW,"04/14/2022",52,4122,47171,18109,11307
PW,"04/21/2022",157,4279,47203,18115,11321
PW,"04/28/2022",207,4486,47291,18134,11348
PW,"05/05/2022",204,4690,47441,18155,11375
PW,"05/12/2022",92,4782,47545,18160,11392
PW,"05/19/2022",154,4936,47675,18172,11419
PW,"05/26/2022",84,5020,47823,18183,11462
PW,"06/02/2022",45,5065,47937,18190,11490
PW,"06/09/2022",61,5126,48164,18200,11584
PW,"06/16/2022",39,5165,48404,18219,11672
RI,"12/17/2020",6972,74693,112,0,""
RI,"12/24/2020",5360,80053,6650,0,""
RI,"12/31/2020",6137,86190,13166,0,""
RI,"01/07/2021",6714,92904,27696,0,""
RI,"01/14/2021",6517,99421,44871,0,""
RI,"01/21/2021",5091,104512,59014,0,""
RI,"01/28/2021",4568,109080,80138,0,""
RI,"02/04/2021",3283,112363,103876,0,""
RI,"02/11/2021",2782,115145,127931,0,""
RI,"02/18/2021",2237,117382,159931,0,""
RI,"02/25/2021",2213,119595,226694,0,""
RI,"03/04/2021",2388,121983,290963,0,""
RI,"03/11/2021",2199,124182,350979,101364,""
RI,"03/18/2021",2132,126314,411715,128504,""
RI,"03/25/2021",2471,128785,497475,186246,""
RI,"04/01/2021",2884,131669,566515,227282,""
RI,"04/08/2021",2617,134286,658852,275166,""
RI,"04/15/2021",2828,137114,742268,322059,""
RI,"04/22/2021",2206,139320,818872,348690,""
RI,"04/29/2021",1712,141032,898947,378325,""
RI,"05/06/2021",1336,142368,957795,415637,""
RI,"05/13/2021",968,143336,1020874,460011,""
RI,"05/20/2021",691,144027,1097137,513205,""
RI,"05/27/2021",461,144488,1141962,536009,""
RI,"06/03/2021",198,144686,1170969,552367,""
RI,"06/10/2021",205,144891,1197352,570000,""
RI,"06/17/2021",144,145035,1236452,597441,""
RI,"06/24/2021",122,145157,1258124,611525,""
RI,"07/01/2021",106,145263,1278902,625477,""
RI,"07/08/2021",141,145404,1288950,631171,""
RI,"07/15/2021",214,145618,1301351,637844,""
RI,"07/22/2021",415,146033,1313042,643774,""
RI,"07/29/2021",752,146785,1325135,648934,""
RI,"08/05/2021",1297,148082,1337970,655569,""
RI,"08/12/2021",1584,149666,1350658,661483,""
RI,"08/19/2021",1974,151640,1364565,671497,""
RI,"08/26/2021",1866,153506,1381130,679825,0
RI,"09/02/2021",2134,155640,1398472,688973,0
RI,"09/09/2021",2043,157683,1413145,696628,0
RI,"09/16/2021",2438,160121,1428626,704928,0
RI,"09/23/2021",2247,162368,1444307,715126,0
RI,"09/30/2021",2055,164423,1461411,723162,0
RI,"10/07/2021",1827,166250,1484954,731457,0
RI,"10/14/2021",1820,168070,1503636,737045,0
RI,"10/21/2021",1633,169703,1523454,742780,46722
RI,"10/28/2021",1348,171051,1552354,748968,66582
RI,"11/04/2021",1600,172651,1589882,753884,94436
RI,"11/11/2021",2059,174710,1628921,757937,120056
RI,"11/18/2021",2824,177534,1673123,761791,145775
RI,"11/25/2021",3534,181068,1714653,765072,173897
RI,"12/02/2021",4445,185513,1758311,771645,203243
RI,"12/09/2021",6089,191602,1812284,787165,237769
RI,"12/16/2021",7263,198865,1866175,797750,275087
RI,"12/23/2021",7992,206857,1914375,804503,310562
RI,"12/30/2021",13943,220800,1948994,809908,337466
RI,"01/06/2022",29255,250055,1981579,815706,361735
RI,"01/13/2022",34256,284311,2019679,822567,389387
RI,"01/20/2022",25722,310033,2051079,827347,393877
RI,"01/27/2022",13761,323794,2075851,833488,409823
RI,"02/03/2022",6777,330571,2092325,839373,419280
RI,"02/10/2022",3795,334366,2101499,844435,425120
RI,"02/17/2022",2252,336618,2116493,849574,431615
RI,"02/24/2022",1455,338073,2125909,853229,436711
RI,"03/03/2022",1253,339326,2134317,855802,441216
RI,"03/10/2022",1049,340375,2141380,858254,444885
RI,"03/17/2022",1231,341606,2147310,860530,448091
RI,"03/24/2022",1194,342800,2152910,862443,451296
RI,"03/31/2022",1249,344049,2158485,864131,454376
RI,"04/07/2022",1721,345770,2172477,866881,458003
RI,"04/14/2022",2366,348136,2188054,869365,461195
RI,"04/21/2022",2282,350418,2200916,871414,463913
RI,"04/28/2022",3020,353438,2213631,873255,466675
RI,"05/05/2022",3991,357429,2224989,875148,469077
RI,"05/12/2022",5092,362521,2236291,876943,471545
RI,"05/19/2022",5643,368164,2248037,879018,474149
RI,"05/26/2022",4186,372350,2259095,880785,476656
RI,"06/02/2022",3221,375571,2269106,882392,479169
RI,"06/09/2022",2659,378230,2277649,884275,481513
RI,"06/16/2022",2048,380278,2284689,885608,483619
SC,"12/17/2020",20676,260120,6831,0,""
SC,"12/24/2020",22110,282230,32670,0,""
SC,"12/31/2020",21245,303475,50258,0,""
SC,"01/07/2021",29760,333235,137086,0,""
SC,"01/14/2021",32143,365378,121836,0,""
SC,"01/21/2021",34465,399843,209631,0,""
SC,"01/28/2021",27388,427231,359949,0,""
SC,"02/04/2021",23563,450794,497433,0,""
SC,"02/11/2021",22346,473140,628496,0,""
SC,"02/18/2021",19229,492369,778113,0,""
SC,"02/25/2021",16675,509044,997874,0,""
SC,"03/04/2021",10952,519996,1202753,0,""
SC,"03/11/2021",8477,528473,1461672,531345,""
SC,"03/18/2021",7627,536100,1686210,609393,""
SC,"03/25/2021",7832,543932,1926363,686118,""
SC,"04/01/2021",7699,551631,2191473,792963,""
SC,"04/08/2021",7000,558631,2491219,943051,""
SC,"04/15/2021",6302,564933,2775374,1110692,""
SC,"04/22/2021",6436,571369,2985791,1239512,""
SC,"04/29/2021",5271,576640,3208817,1386994,""
SC,"05/06/2021",5199,581839,3357973,1488726,""
SC,"05/13/2021",3761,585600,3507825,1591804,""
SC,"05/20/2021",3871,589471,3619220,1657313,""
SC,"05/27/2021",2363,591834,3723594,1710606,""
SC,"06/03/2021",1550,593384,3794396,1750335,""
SC,"06/10/2021",1060,594444,3900324,1818527,""
SC,"06/17/2021",773,595217,3994316,1877766,""
SC,"06/24/2021",626,595843,4103290,1931587,""
SC,"07/01/2021",970,596813,4198578,1996786,""
SC,"07/08/2021",1414,598227,4240109,2019650,""
SC,"07/15/2021",2379,600606,4285522,2041964,""
SC,"07/22/2021",4047,604653,4331825,2064053,""
SC,"07/29/2021",8380,613033,4390078,2084501,""
SC,"08/05/2021",15170,628203,4458668,2106365,""
SC,"08/12/2021",20305,648508,4533845,2129360,""
SC,"08/19/2021",24664,673172,4629625,2160879,""
SC,"08/26/2021",29722,702894,4730803,2199269,0
SC,"09/02/2021",37740,740634,4845846,2246101,0
SC,"09/09/2021",35708,776342,4948269,2288565,0
SC,"09/16/2021",33438,809780,5060158,2339269,0
SC,"09/23/2021",25100,834880,5163049,2390767,0
SC,"09/30/2021",19995,854875,5262891,2433429,0
SC,"10/07/2021",14963,869838,5373651,2471601,0
SC,"10/14/2021",11146,880984,5476846,2508681,0
SC,"10/21/2021",8116,889100,5563700,2537999,209883
SC,"10/28/2021",5824,894924,5668206,2563956,263893
SC,"11/04/2021",5544,900468,5786565,2585008,333832
SC,"11/11/2021",4711,905179,5897812,2603614,395379
SC,"11/18/2021",4727,909906,6020753,2621180,457448
SC,"11/25/2021",5060,914966,6118807,2634512,511988
SC,"12/02/2021",4220,919186,6233129,2655290,573446
SC,"12/09/2021",7269,926455,6388107,2682726,660870
SC,"12/16/2021",7299,933754,6501249,2703481,725572
SC,"12/23/2021",8606,942360,6623650,2721525,798606
SC,"12/30/2021",17835,960195,6713342,2735224,849471
SC,"01/06/2022",58240,1018435,6805135,2749856,899480
SC,"01/13/2022",96346,1114781,6922505,2768707,963022
SC,"01/20/2022",121951,1236732,6997241,2806285,1003152
SC,"01/27/2022",91718,1328450,7051599,2819390,1028362
SC,"02/03/2022",66201,1394651,7101195,2833644,1049964
SC,"02/10/2022",33218,1427869,7142865,2844523,1066621
SC,"02/17/2022",17514,1445383,7212479,2856561,1079471
SC,"02/24/2022",11615,1456998,7253946,2870932,1094237
SC,"03/03/2022",4793,1461791,7287794,2880832,1108356
SC,"03/10/2022",2422,1464213,7328492,2897171,1119848
SC,"03/17/2022",1523,1465736,7345261,2902895,1126235
SC,"03/24/2022",1376,1467112,7357045,2906373,1130955
SC,"03/31/2022",1022,1468134,7372274,2910580,1137303
SC,"04/07/2022",1565,1469699,7386236,2913936,1141497
SC,"04/14/2022",898,1470597,7387433,2914767,1141910
SC,"04/21/2022",1496,1472093,7388247,2915558,1142285
SC,"04/28/2022",2181,1474274,7389545,2916467,1142653
SC,"05/05/2022",3186,1477460,7543051,2937076,1174118
SC,"05/12/2022",4515,1481975,7572102,2941683,1179926
SC,"05/19/2022",5753,1487728,7603575,2946605,1186220
SC,"05/26/2022",8034,1495762,7644190,2952221,1194526
SC,"06/02/2022",9205,1504967,7669346,2956013,1199972
SC,"06/09/2022",9456,1514423,7691681,2959887,1205006
SC,"06/16/2022",10348,1524771,7712591,2962906,1210080
SD,"12/17/2020",4581,92604,410,0,""
SD,"12/24/2020",3435,96039,9085,0,""
SD,"12/31/2020",2682,98721,21154,0,""
SD,"01/07/2021",2957,101678,33389,0,""
SD,"01/14/2021",2497,104175,54284,0,""
SD,"01/21/2021",1864,106039,65377,0,""
SD,"01/28/2021",1572,107611,91776,0,""
SD,"02/04/2021",1027,108638,115676,0,""
SD,"02/11/2021",940,109578,141733,0,""
SD,"02/18/2021",1105,110683,171175,0,""
SD,"02/25/2021",1124,111807,250216,0,""
SD,"03/04/2021",1023,112830,294765,0,""
SD,"03/11/2021",1122,113952,339564,119696,""
SD,"03/18/2021",1007,114959,392994,145825,""
SD,"03/25/2021",1393,116352,445142,172622,""
SD,"04/01/2021",1404,117756,505081,202298,""
SD,"04/08/2021",1220,118976,560263,229617,""
SD,"04/15/2021",1403,120379,611743,260782,""
SD,"04/22/2021",1138,121517,650608,286542,""
SD,"04/29/2021",880,122397,691904,318790,""
SD,"05/06/2021",671,123068,720317,341966,""
SD,"05/13/2021",446,123514,739400,356620,""
SD,"05/20/2021",308,123822,756721,366351,""
SD,"05/27/2021",241,124063,770321,372526,""
SD,"06/03/2021",150,124213,778977,377032,""
SD,"06/10/2021",86,124299,789532,383451,""
SD,"06/17/2021",73,124372,803090,391806,""
SD,"06/24/2021",94,124466,811591,396626,""
SD,"07/01/2021",80,124546,820728,402310,""
SD,"07/08/2021",104,124650,826634,405443,""
SD,"07/15/2021",112,124762,832485,408372,""
SD,"07/22/2021",197,124959,839940,411392,""
SD,"07/29/2021",265,125224,848103,414305,""
SD,"08/05/2021",375,125599,857799,417625,""
SD,"08/12/2021",858,126457,868447,421633,""
SD,"08/19/2021",1239,127696,879400,426003,""
SD,"08/26/2021",2169,129865,893241,431757,0
SD,"09/02/2021",2972,132837,907402,437192,0
SD,"09/09/2021",2700,135537,919366,441859,0
SD,"09/16/2021",3323,138860,931234,446788,0
SD,"09/23/2021",2884,141744,942416,452353,0
SD,"09/30/2021",2804,144548,957432,457326,0
SD,"10/07/2021",2448,146996,972498,460500,0
SD,"10/14/2021",2341,149337,989344,464516,0
SD,"10/21/2021",2217,151554,996850,459886,33503
SD,"10/28/2021",2221,153775,1016852,464077,43661
SD,"11/04/2021",2348,156123,1047307,468325,62442
SD,"11/11/2021",2699,158822,1077247,473768,80364
SD,"11/18/2021",2650,161472,1105423,476975,95125
SD,"11/25/2021",2819,164291,1135140,480731,107822
SD,"12/02/2021",2849,167140,1159322,485472,119170
SD,"12/09/2021",3260,170400,1194191,492226,138004
SD,"12/16/2021",2362,172762,1219474,497363,151094
SD,"12/23/2021",2484,175246,1243823,501708,163865
SD,"12/30/2021",3148,178394,1261116,505031,172309
SD,"01/06/2022",6890,185284,1276844,508494,179485
SD,"01/13/2022",12628,197912,1294262,511966,187677
SD,"01/20/2022",13973,211885,1308784,516850,194395
SD,"01/27/2022",10996,222881,1320647,519580,199728
SD,"02/03/2022",6011,228892,1330763,522291,203851
SD,"02/10/2022",3048,231940,1338962,524860,206984
SD,"02/17/2022",1750,233690,1347735,527134,209155
SD,"02/24/2022",1827,235517,1352959,528863,211006
SD,"03/03/2022",600,236117,1357476,530612,212641
SD,"03/10/2022",376,236493,1361824,532109,214054
SD,"03/17/2022",252,236745,1365848,533287,215611
SD,"03/24/2022",205,236950,1369399,534203,217066
SD,"03/31/2022",154,237104,1374021,535202,218852
SD,"04/07/2022",137,237241,1382381,537286,220755
SD,"04/14/2022",127,237368,1392124,539233,222518
SD,"04/21/2022",167,237535,1401226,541082,224271
SD,"04/28/2022",277,237812,1410134,542777,225820
SD,"05/05/2022",370,238182,1418524,544235,227235
SD,"05/12/2022",453,238635,1427040,545826,228788
SD,"05/19/2022",474,239109,1433822,547184,230043
SD,"05/26/2022",594,239703,1439796,548387,231263
SD,"06/02/2022",650,240353,1445954,549650,232556
SD,"06/09/2022",970,241323,1451667,550801,233845
SD,"06/16/2022",974,242297,1456433,551774,234891
TN,"12/17/2020",63931,482312,0,0,""
TN,"12/24/2020",54213,536525,45154,0,""
TN,"12/31/2020",39811,576336,87338,0,""
TN,"01/07/2021",46286,622622,179811,0,""
TN,"01/14/2021",38527,661149,264713,0,""
TN,"01/21/2021",27870,689019,375669,0,""
TN,"01/28/2021",21014,710033,510050,0,""
TN,"02/04/2021",17722,727755,684242,0,""
TN,"02/11/2021",16120,743875,866352,0,""
TN,"02/18/2021",10176,754051,1014351,0,""
TN,"02/25/2021",9501,763552,1210159,0,""
TN,"03/04/2021",8476,772028,1492576,0,""
TN,"03/11/2021",8819,780847,1757433,607004,""
TN,"03/18/2021",8499,789346,2054500,702983,""
TN,"03/25/2021",8907,798253,2353612,815079,""
TN,"04/01/2021",8006,806259,2725411,972815,""
TN,"04/08/2021",7552,813811,3058344,1128731,""
TN,"04/15/2021",8164,821975,3382287,1294250,""
TN,"04/22/2021",10150,832125,3699866,1474314,""
TN,"04/29/2021",7527,839652,3968801,1644492,""
TN,"05/06/2021",5914,845566,4204260,1802156,""
TN,"05/13/2021",5113,850679,4436045,1953189,""
TN,"05/20/2021",4038,854717,4650520,2072318,""
TN,"05/27/2021",2985,857702,4790132,2139212,""
TN,"06/03/2021",2045,859747,4873939,2182063,""
TN,"06/10/2021",1622,861369,4963190,2232783,""
TN,"06/17/2021",1546,862915,5110100,2328568,""
TN,"06/24/2021",1181,864096,5189585,2370814,""
TN,"07/01/2021",1485,865581,5283873,2421025,""
TN,"07/08/2021",2186,867767,5508741,2579292,""
TN,"07/15/2021",3855,871622,5576501,2610183,""
TN,"07/22/2021",6370,877992,5644363,2637211,""
TN,"07/29/2021",12283,890275,5725029,2661298,""
TN,"08/05/2021",18787,909062,5822662,2689066,""
TN,"08/12/2021",26484,935546,5928462,2718621,""
TN,"08/19/2021",33333,968879,6059413,2761932,""
TN,"08/26/2021",43590,1012469,6209091,2814925,0
TN,"09/02/2021",50367,1062836,6369444,2876446,0
TN,"09/09/2021",54562,1117398,6496367,2928361,0
TN,"09/16/2021",52367,1169765,6634734,2992530,0
TN,"09/23/2021",32060,1201825,6755410,3054167,0
TN,"09/30/2021",24429,1226254,6875072,3103098,0
TN,"10/07/2021",18167,1244421,7018075,3146428,0
TN,"10/14/2021",13987,1258408,7153656,3185773,0
TN,"10/21/2021",10370,1268778,7259764,3217606,277528
TN,"10/28/2021",8091,1276869,7397726,3246755,359839
TN,"11/04/2021",6925,1283794,7558106,3270354,464432
TN,"11/11/2021",7813,1291607,7760760,3328865,559321
TN,"11/18/2021",8583,1300190,7940729,3355930,653342
TN,"11/25/2021",9275,1309465,8081410,3372783,738292
TN,"12/02/2021",9439,1318904,8234345,3392571,830495
TN,"12/09/2021",13087,1331991,8432555,3427141,951263
TN,"12/16/2021",12113,1344104,8649467,3468426,1057847
TN,"12/23/2021",20450,1364554,8809725,3490856,1161428
TN,"12/30/2021",45563,1410117,8922799,3507440,1230753
TN,"01/06/2022",82844,1492961,9033505,3525049,1294313
TN,"01/13/2022",101053,1594014,9138553,3542558,1352175
TN,"01/20/2022",116857,1710871,9231760,3578227,1402796
TN,"01/27/2022",112238,1823109,9298258,3592810,1435607
TN,"02/03/2022",78816,1901925,9370101,3609447,1468491
TN,"02/10/2022",54875,1956800,9420477,3622457,1490447
TN,"02/17/2022",27275,1984075,9489474,3634967,1509522
TN,"02/24/2022",14834,1998909,9577064,3654266,1539708
TN,"03/03/2022",9141,2008050,9613218,3664475,1552992
TN,"03/10/2022",4073,2012123,9644453,3672213,1564928
TN,"03/17/2022",2328,2014451,9669251,3678317,1574184
TN,"03/24/2022",1908,2016359,9693506,3683811,1583604
TN,"03/31/2022",1562,2017921,9718206,3689874,1592318
TN,"04/07/2022",1751,2019672,9770847,3698571,1604702
TN,"04/14/2022",2138,2021810,9835551,3706219,1614272
TN,"04/21/2022",2526,2024336,9897484,3715112,1625586
TN,"04/28/2022",3261,2027597,9939457,3719940,1632880
TN,"05/05/2022",4063,2031660,9979981,3724717,1640133
TN,"05/12/2022",5906,2037566,10016257,3729083,1646695
TN,"05/19/2022",7644,2045210,10059931,3734451,1654783
TN,"05/26/2022",10040,2055250,10100592,3738903,1662890
TN,"06/02/2022",10462,2065712,10132822,3742756,1669840
TN,"06/09/2022",12893,2078605,10165764,3746882,1677045
TN,"06/16/2022",13300,2091905,10194895,3750399,1683414
TX,"12/17/2020",121612,1483426,58150,0,""
TX,"12/24/2020",133398,1616824,250004,0,""
TX,"12/31/2020",114742,1731566,518000,0,""
TX,"01/07/2021",150087,1881653,873413,0,""
TX,"01/14/2021",153453,2035106,1358291,0,""
TX,"01/21/2021",136650,2171756,1544551,0,""
TX,"01/28/2021",112996,2284752,2107005,0,""
TX,"02/04/2021",101609,2386361,2805359,0,""
TX,"02/11/2021",81329,2467690,3708460,0,""
TX,"02/18/2021",50686,2518376,4333726,0,""
TX,"02/25/2021",34898,2553274,5107257,0,""
TX,"03/04/2021",47658,2600932,6379094,0,""
TX,"03/11/2021",30146,2631078,7730664,2598847,""
TX,"03/18/2021",24802,2655880,9055037,2986118,""
TX,"03/25/2021",25910,2681790,10133617,3341681,""
TX,"04/01/2021",26089,2707879,11950969,4153575,""
TX,"04/08/2021",22138,2730017,13825974,5069262,""
TX,"04/15/2021",24277,2754294,15897950,6158775,""
TX,"04/22/2021",23885,2778179,17307611,6882900,""
TX,"04/29/2021",22339,2800518,18622188,7654594,""
TX,"05/06/2021",22080,2822598,19690275,8365487,""
TX,"05/13/2021",18287,2840885,20671478,9058956,""
TX,"05/20/2021",15251,2856136,21719251,9654297,""
TX,"05/27/2021",12237,2868373,22593372,10088586,""
TX,"06/03/2021",12121,2880494,23178516,10395423,""
TX,"06/10/2021",10548,2891042,23847099,10787111,""
TX,"06/17/2021",9785,2900827,24735511,11331694,""
TX,"06/24/2021",11464,2912291,25215418,11625904,""
TX,"07/01/2021",14270,2926561,25756467,11974642,""
TX,"07/08/2021",34687,2961248,26080182,12144561,""
TX,"07/15/2021",89320,3050568,26448461,12341791,""
TX,"07/22/2021",30509,3081077,26817055,12503152,""
TX,"07/29/2021",55081,3136158,27256486,12658112,""
TX,"08/05/2021",89925,3226083,27779346,12835583,""
TX,"08/12/2021",88577,3314660,28324847,13000265,""
TX,"08/19/2021",117078,3431738,29006363,13255217,""
TX,"08/26/2021",101470,3533208,29733757,13555811,0
TX,"09/02/2021",120394,3653602,30362085,13845631,0
TX,"09/09/2021",135437,3789039,30866751,14094863,0
TX,"09/16/2021",97706,3886745,31378670,14350444,0
TX,"09/23/2021",71521,3958266,32007401,14680274,0
TX,"09/30/2021",76429,4034695,32309531,14813685,0
TX,"10/07/2021",51871,4086566,32864271,15012446,0
TX,"10/14/2021",42613,4129179,33296932,15152191,0
TX,"10/21/2021",31225,4160404,33708778,15283608,1012482
TX,"10/28/2021",28182,4188586,34292378,15432142,1317641
TX,"11/04/2021",23339,4211925,34907099,15532524,1678197
TX,"11/11/2021",23795,4235720,35423556,15608461,1979651
TX,"11/18/2021",24021,4259741,36079806,15718599,2344379
TX,"11/25/2021",22041,4281782,36862434,15793073,2661067
TX,"12/02/2021",22468,4304250,37460779,15909783,2964776
TX,"12/09/2021",35688,4339938,38412226,16127692,3447636
TX,"12/16/2021",31848,4371786,39181593,16292326,3846945
TX,"12/23/2021",64289,4436075,40018615,16423346,4318366
TX,"12/30/2021",104290,4540365,40612073,16517363,4639917
TX,"01/06/2022",428291,4968656,41184969,16610658,4934151
TX,"01/13/2022",375686,5344342,41858108,16727778,5275627
TX,"01/20/2022",430550,5774892,42413592,16892429,5549015
TX,"01/27/2022",348510,6123402,42901178,17012733,5751342
TX,"02/03/2022",231629,6355031,43287971,17117132,5904763
TX,"02/10/2022",127338,6482369,43583394,17205238,6009993
TX,"02/17/2022",74515,6556884,43990926,17298720,6109679
TX,"02/24/2022",45216,6602100,44254223,17374227,6193059
TX,"03/03/2022",29967,6632067,44500682,17444705,6257276
TX,"03/10/2022",26128,6658195,44693438,17494744,6312461
TX,"03/17/2022",24790,6682985,44896223,17544668,6365503
TX,"03/24/2022",30477,6713462,45071300,17586929,6427676
TX,"03/31/2022",24123,6737585,45230513,17629456,6480411
TX,"04/07/2022",18825,6756410,45552765,17687434,6553345
TX,"04/14/2022",17443,6773853,45823885,17722578,6613204
TX,"04/21/2022",15468,6789321,46074892,17759829,6667029
TX,"04/28/2022",16577,6805898,46664569,17795667,6760070
TX,"05/05/2022",17397,6823295,46869326,17834397,6804777
TX,"05/12/2022",20986,6844281,47067110,17871703,6847667
TX,"05/19/2022",25573,6869854,47257059,17901037,6888389
TX,"05/26/2022",30836,6900690,47466160,17935111,6936667
TX,"06/02/2022",37177,6937867,47621003,17957312,6976709
TX,"06/09/2022",46845,6984712,47788655,17983664,7019620
TX,"06/16/2022",48265,7032977,47941117,18006026,7059407
UT,"12/17/2020",18370,242452,81,0,""
UT,"12/24/2020",17084,259536,11434,0,""
UT,"12/31/2020",14372,273908,24295,0,""
UT,"01/07/2021",21015,294923,62863,0,""
UT,"01/14/2021",19967,314890,115384,0,""
UT,"01/21/2021",13453,328343,189578,0,""
UT,"01/28/2021",12287,340630,239807,0,""
UT,"02/04/2021",9322,349952,353469,0,""
UT,"02/11/2021",7364,357316,510267,0,""
UT,"02/18/2021",5887,363203,551742,0,""
UT,"02/25/2021",5364,368567,662012,0,""
UT,"03/04/2021",4109,372676,746392,0,""
UT,"03/11/2021",3611,376287,903758,244148,""
UT,"03/18/2021",3475,379762,1069752,286393,""
UT,"03/25/2021",2955,382717,1213732,330233,""
UT,"04/01/2021",2903,385620,1380946,379843,""
UT,"04/08/2021",2801,388421,1573343,468812,""
UT,"04/15/2021",2753,391174,1784313,574862,""
UT,"04/22/2021",2679,393853,1970752,668588,""
UT,"04/29/2021",2659,396512,2116081,749497,""
UT,"05/06/2021",2455,398967,2243163,827388,""
UT,"05/13/2021",2264,401231,2367479,916716,""
UT,"05/20/2021",2179,403410,2473783,979914,""
UT,"05/27/2021",1661,405071,2561967,1026238,""
UT,"06/03/2021",1407,406478,2591302,1042991,""
UT,"06/10/2021",1944,408422,2646617,1078369,""
UT,"06/17/2021",1948,410370,2758879,1150170,""
UT,"06/24/2021",2171,412541,2808430,1175281,""
UT,"07/01/2021",2590,415131,2856977,1201088,""
UT,"07/08/2021",2522,417653,2884433,1214449,""
UT,"07/15/2021",3602,421255,2917259,1398606,""
UT,"07/22/2021",4346,425601,2958795,1417434,""
UT,"07/29/2021",4538,430139,2993638,1432218,""
UT,"08/05/2021",6347,436486,3030004,1446600,""
UT,"08/12/2021",5744,442230,3092258,1469482,""
UT,"08/19/2021",7018,449248,3134432,1485361,""
UT,"08/26/2021",7846,457094,3210561,1514953,0
UT,"09/02/2021",9004,466098,3247610,1531136,0
UT,"09/09/2021",9527,475625,3295791,1554146,0
UT,"09/16/2021",11721,487346,3335557,1573636,0
UT,"09/23/2021",10073,497419,3391571,1603112,0
UT,"09/30/2021",9376,506795,3427654,1622171,0
UT,"10/07/2021",9933,516728,3493005,1652853,0
UT,"10/14/2021",9651,526379,3557354,1674027,0
UT,"10/21/2021",8515,534894,3622509,1694164,86852
UT,"10/28/2021",11295,546189,3664969,1707653,105693
UT,"11/04/2021",10246,556435,3750315,1729045,151405
UT,"11/11/2021",11261,567696,3847547,1747244,212608
UT,"11/18/2021",11708,579404,3935788,1762378,255847
UT,"11/25/2021",10327,589731,4001214,1770907,283888
UT,"12/02/2021",8403,598134,4120360,1787152,347895
UT,"12/09/2021",9901,608035,4242734,1819089,413263
UT,"12/16/2021",7595,615630,4361984,1851243,474605
UT,"12/23/2021",6867,622497,4444635,1870704,521010
UT,"12/30/2021",10925,633422,4522177,1885083,567274
UT,"01/06/2022",29982,663404,4564340,1892524,592861
UT,"01/13/2022",62586,725990,4628594,1906748,628476
UT,"01/20/2022",76633,802623,4699321,1928698,669152
UT,"01/27/2022",59253,861876,4769125,1941422,709176
UT,"02/03/2022",29922,891798,4836866,1953194,747881
UT,"02/10/2022",15250,907048,4970652,2004257,828320
UT,"02/17/2022",9074,916122,5040640,2021420,856756
UT,"02/24/2022",4831,920953,5062117,2027921,866357
UT,"03/03/2022",2827,923780,5070250,2030252,870013
UT,"03/10/2022",1571,925351,5079891,2033030,874333
UT,"03/17/2022",1141,926492,5100962,2038845,883364
UT,"03/24/2022",887,927379,5116039,2042857,889973
UT,"03/31/2022",800,928179,5121680,2044536,892243
UT,"04/07/2022",702,928881,5157278,2052866,905569
UT,"04/14/2022",746,929627,5157791,2053068,905758
UT,"04/21/2022",1188,930815,5185035,2057127,911417
UT,"04/28/2022",1642,932457,5185507,2057276,911569
UT,"05/05/2022",2494,934951,5219240,2061467,918181
UT,"05/12/2022",3241,938192,5244415,2065212,923978
UT,"05/19/2022",4290,942482,5265899,2067731,928781
UT,"05/26/2022",5499,947981,5266356,2067896,928927
UT,"06/02/2022",5485,953466,5284715,2069656,932860
UT,"06/09/2022",7537,961003,5284981,2069796,932950
UT,"06/16/2022",6619,967622,5305941,2071821,938164
VA,"12/17/2020",25128,292241,271,0,""
VA,"12/24/2020",26893,319134,32968,0,""
VA,"12/31/2020",25210,344344,79421,0,""
VA,"01/07/2021",32965,377309,167398,0,""
VA,"01/14/2021",35266,412575,244234,0,""
VA,"01/21/2021",43025,455600,362092,0,""
VA,"01/28/2021",32937,488537,668401,0,""
VA,"02/04/2021",24762,513299,949066,0,""
VA,"02/11/2021",23949,537248,1223199,0,""
VA,"02/18/2021",18023,555271,1503786,0,""
VA,"02/25/2021",13475,568746,1848774,0,""
VA,"03/04/2021",11041,579787,2284452,0,""
VA,"03/11/2021",9119,588906,2685399,985449,""
VA,"03/18/2021",9384,598290,3091883,1135711,""
VA,"03/25/2021",10234,608524,3529449,1277347,""
VA,"04/01/2021",10268,618792,4140842,1490091,""
VA,"04/08/2021",10164,628956,4744344,1769743,""
VA,"04/15/2021",11075,640031,5345259,2086620,""
VA,"04/22/2021",9428,649459,5968173,2418109,""
VA,"04/29/2021",7420,656879,6540658,2739248,""
VA,"05/06/2021",6278,663157,7043683,3048290,""
VA,"05/13/2021",4458,667615,7451290,3325691,""
VA,"05/20/2021",3024,670639,7833818,3562369,""
VA,"05/27/2021",2671,673310,8193249,3759142,""
VA,"06/03/2021",1696,675006,8406035,3881990,""
VA,"06/10/2021",1367,676373,8649084,4033134,""
VA,"06/17/2021",993,677366,8907825,4208431,""
VA,"06/24/2021",929,678295,9109659,4338863,""
VA,"07/01/2021",1615,679910,9249165,4433088,""
VA,"07/08/2021",1449,681359,9348211,4489618,""
VA,"07/15/2021",2125,683484,9447214,4544376,""
VA,"07/22/2021",3287,686771,9540790,4594024,""
VA,"07/29/2021",5344,692115,9643507,4637990,""
VA,"08/05/2021",8937,701052,9756661,4681679,""
VA,"08/12/2021",12143,713195,9878495,4729067,""
VA,"08/19/2021",15329,728524,10004762,4778991,""
VA,"08/26/2021",19117,747641,10151885,4838898,0
VA,"09/02/2021",22201,769842,10277952,4903533,0
VA,"09/09/2021",23554,793396,10410207,4959123,0
VA,"09/16/2021",25407,818803,10550840,5022557,0
VA,"09/23/2021",24279,843082,10723697,5107217,0
VA,"09/30/2021",20586,863668,10882638,5170550,0
VA,"10/07/2021",18705,882373,11065456,5221636,0
VA,"10/14/2021",15388,897761,11240293,5273043,0
VA,"10/21/2021",13352,911113,11421829,5321585,336244
VA,"10/28/2021",10241,921354,11691565,5372576,499915
VA,"11/04/2021",9064,930418,11944366,5406767,668825
VA,"11/11/2021",9272,939690,12256306,5448611,847100
VA,"11/18/2021",10111,949801,12588508,5481307,1018965
VA,"11/25/2021",10907,960708,12883121,5516063,1181437
VA,"12/02/2021",10822,971530,13178709,5564468,1347055
VA,"12/09/2021",16619,988149,13563316,5660070,1555143
VA,"12/16/2021",18104,1006253,13896642,5726493,1750449
VA,"12/23/2021",27869,1034122,14232148,5773527,1961175
VA,"12/30/2021",53283,1087405,14449479,5800214,2096635
VA,"01/06/2022",99482,1186887,14678360,5831063,2234862
VA,"01/13/2022",128369,1315256,14930453,5867830,2388294
VA,"01/20/2022",104592,1419848,15112989,5989310,2497774
VA,"01/27/2022",82823,1502671,15231999,6012324,2561248
VA,"02/03/2022",54477,1557148,15336892,6034960,2614150
VA,"02/10/2022",34412,1591560,15554399,6083844,2724662
VA,"02/17/2022",22348,1613908,15781611,6116063,2763033
VA,"02/24/2022",15327,1629235,15848582,6135445,2791665
VA,"03/03/2022",10451,1639686,15905289,6151333,2815671
VA,"03/10/2022",7232,1646918,15951612,6164151,2834665
VA,"03/17/2022",7081,1653999,15992551,6174658,2852612
VA,"03/24/2022",5448,1659447,16034785,6184101,2869002
VA,"03/31/2022",5255,1664702,16069714,6192134,2883644
VA,"04/07/2022",6092,1670794,16165692,6205632,2901627
VA,"04/14/2022",7978,1678772,16272056,6218953,2918102
VA,"04/21/2022",7828,1686600,16367829,6230535,2932075
VA,"04/28/2022",10269,1696869,16448458,6240886,2945110
VA,"05/05/2022",12782,1709651,16528881,6252938,2958712
VA,"05/12/2022",16398,1726049,16608124,6263342,2972023
VA,"05/19/2022",20734,1746783,16687901,6273499,2984918
VA,"05/26/2022",22988,1769771,16768003,6283367,3000243
VA,"06/02/2022",20090,1789861,16836166,6291524,3016152
VA,"06/09/2022",20564,1810425,16899835,6299592,3031448
VA,"06/16/2022",18595,1829020,16948298,6306081,3043178
VI,"12/17/2020",130,1828,22,0,""
VI,"12/24/2020",139,1967,298,0,""
VI,"12/31/2020",64,2031,706,0,""
VI,"01/07/2021",75,2106,1326,0,""
VI,"01/14/2021",60,2166,1444,0,""
VI,"01/21/2021",139,2305,2744,0,""
VI,"01/28/2021",68,2373,4620,0,""
VI,"02/04/2021",67,2440,8212,0,""
VI,"02/11/2021",65,2505,11168,0,""
VI,"02/18/2021",53,2558,13648,0,""
VI,"02/25/2021",65,2623,17778,0,""
VI,"03/04/2021",72,2695,21615,0,""
VI,"03/11/2021",66,2761,25361,8102,""
VI,"03/18/2021",42,2803,30128,9461,""
VI,"03/25/2021",73,2876,35728,11729,""
VI,"04/01/2021",31,2907,42298,15088,""
VI,"04/08/2021",47,2954,48176,18609,""
VI,"04/15/2021",51,3005,54127,21693,""
VI,"04/22/2021",39,3044,58550,24133,""
VI,"04/29/2021",54,3098,61600,25989,""
VI,"05/06/2021",80,3178,64680,27803,""
VI,"05/13/2021",78,3256,66703,28909,""
VI,"05/20/2021",52,3308,68713,29955,""
VI,"05/27/2021",91,3399,70325,30801,""
VI,"06/03/2021",140,3539,71983,31679,""
VI,"06/10/2021",113,3652,73548,32526,""
VI,"06/17/2021",95,3747,75435,33586,""
VI,"06/24/2021",72,3819,76870,34412,""
VI,"07/01/2021",60,3879,78145,35112,""
VI,"07/08/2021",91,3970,79196,35666,""
VI,"07/15/2021",134,4104,80500,36246,""
VI,"07/22/2021",182,4286,81952,36841,""
VI,"07/29/2021",211,4497,83901,37337,""
VI,"08/05/2021",280,4777,86219,37985,""
VI,"08/12/2021",316,5093,88700,38944,""
VI,"08/19/2021",320,5413,91166,40247,""
VI,"08/26/2021",294,5707,93763,41814,0
VI,"09/02/2021",227,5934,95716,42995,0
VI,"09/09/2021",168,6102,97437,44120,0
VI,"09/16/2021",249,6351,99401,45167,0
VI,"09/23/2021",206,6557,100999,45959,0
VI,"09/30/2021",164,6721,102503,46632,0
VI,"10/07/2021",164,6885,104277,47404,0
VI,"10/14/2021",93,6978,105578,47859,0
VI,"10/21/2021",121,7099,107054,48370,2017
VI,"10/28/2021",73,7172,108556,48933,2600
VI,"11/04/2021",79,7251,110005,49338,3295
VI,"11/11/2021",78,7329,111848,49789,4244
VI,"11/18/2021",68,7397,113666,50173,5116
VI,"11/25/2021",93,7490,118595,51904,6008
VI,"12/02/2021",24,7514,120929,52251,7073
VI,"12/09/2021",68,7582,123743,52724,8641
VI,"12/16/2021",42,7624,126099,53133,9826
VI,"12/23/2021",139,7763,128330,53498,10950
VI,"12/30/2021",962,8725,129938,53783,11877
VI,"01/06/2022",2435,11160,131718,54017,12822
VI,"01/13/2022",1950,13110,133587,54326,13748
VI,"01/20/2022",918,14028,135323,54776,14307
VI,"01/27/2022",661,14689,136419,55077,14755
VI,"02/03/2022",246,14935,137445,55354,15083
VI,"02/10/2022",193,15128,138319,55585,15345
VI,"02/17/2022",118,15246,139247,55784,15575
VI,"02/24/2022",81,15327,139733,55901,15733
VI,"03/03/2022",83,15410,140245,56006,15890
VI,"03/10/2022",34,15444,140729,56152,16003
VI,"03/17/2022",128,15572,141133,56272,16095
VI,"03/24/2022",24,15596,141433,56381,16168
VI,"03/31/2022",40,15636,141614,56429,16231
VI,"04/07/2022",90,15726,141974,56494,16308
VI,"04/14/2022",110,15836,142620,56582,16449
VI,"04/21/2022",119,15955,143006,56618,16520
VI,"04/28/2022",305,16260,144588,56747,17208
VI,"05/05/2022",658,16918,145407,56827,17496
VI,"05/12/2022",754,17672,146424,56930,17841
VI,"05/19/2022",879,18551,147055,57022,17935
VI,"05/26/2022",701,19252,147449,57097,17998
VI,"06/02/2022",719,19971,147755,57142,18050
VI,"06/09/2022",361,20332,148101,57219,18094
VI,"06/16/2022",230,20562,148267,57255,18124
VT,"12/17/2020",740,5764,77,0,""
VT,"12/24/2020",706,6470,5466,0,""
VT,"12/31/2020",604,7074,12241,0,""
VT,"01/07/2021",782,7856,20839,0,""
VT,"01/14/2021",1162,9018,32470,0,""
VT,"01/21/2021",1142,10160,42835,0,""
VT,"01/28/2021",962,11122,58871,0,""
VT,"02/04/2021",869,11991,77198,0,""
VT,"02/11/2021",927,12918,96908,0,""
VT,"02/18/2021",830,13748,118184,0,""
VT,"02/25/2021",757,14505,147828,0,""
VT,"03/04/2021",697,15202,175767,0,""
VT,"03/11/2021",893,16095,212062,71639,""
VT,"03/18/2021",816,16911,252439,86222,""
VT,"03/25/2021",859,17770,290680,99990,""
VT,"04/01/2021",1102,18872,333676,119943,""
VT,"04/08/2021",1288,20160,385034,145510,""
VT,"04/15/2021",1054,21214,448151,181510,""
VT,"04/22/2021",821,22035,502374,207703,""
VT,"04/29/2021",561,22596,556060,229298,""
VT,"05/06/2021",540,23136,606172,253677,""
VT,"05/13/2021",377,23513,655013,279619,""
VT,"05/20/2021",369,23882,697965,305465,""
VT,"05/27/2021",229,24111,751854,333208,""
VT,"06/03/2021",100,24211,780410,354287,""
VT,"06/10/2021",73,24284,804718,373214,""
VT,"06/17/2021",49,24333,830662,394874,""
VT,"06/24/2021",35,24368,842306,403019,""
VT,"07/01/2021",33,24401,852491,409864,""
VT,"07/08/2021",36,24437,857349,412905,""
VT,"07/15/2021",47,24484,862181,415717,""
VT,"07/22/2021",87,24571,867441,418829,""
VT,"07/29/2021",163,24734,871503,420798,""
VT,"08/05/2021",259,24993,875922,422693,""
VT,"08/12/2021",489,25482,856595,416691,""
VT,"08/19/2021",785,26267,862760,419274,""
VT,"08/26/2021",792,27059,869145,421851,0
VT,"09/02/2021",896,27955,875335,424323,0
VT,"09/09/2021",1106,29061,880643,426617,0
VT,"09/16/2021",1095,30156,886438,429145,0
VT,"09/23/2021",1525,31681,891319,431228,0
VT,"09/30/2021",1342,33023,897919,433565,0
VT,"10/07/2021",1180,34203,913074,435683,0
VT,"10/14/2021",1446,35649,932853,439115,0
VT,"10/21/2021",1653,37302,946774,441045,39063
VT,"10/28/2021",1518,38820,964013,443246,51687
VT,"11/04/2021",1431,40251,997823,445881,78301
VT,"11/11/2021",2066,42317,1032086,448360,104259
VT,"11/18/2021",2515,44832,1067217,450749,126242
VT,"11/25/2021",2565,47397,1101607,453418,147118
VT,"12/02/2021",2179,49576,1126723,456006,162907
VT,"12/09/2021",3315,52891,1166265,464972,186006
VT,"12/16/2021",2974,55865,1198877,473952,204259
VT,"12/23/2021",2853,58718,1229068,479602,223024
VT,"12/30/2021",2791,61509,1249496,482925,235609
VT,"01/06/2022",5458,66967,1266574,485667,246026
VT,"01/13/2022",12286,79253,1288855,488977,260456
VT,"01/20/2022",11314,90567,1307285,492527,272329
VT,"01/27/2022",8446,99013,1319061,494414,279409
VT,"02/03/2022",5022,104035,1327681,496026,283921
VT,"02/10/2022",3101,107136,1333332,497411,287003
VT,"02/17/2022",2197,109333,1339753,498844,289608
VT,"02/24/2022",1654,110987,1344313,499883,291711
VT,"03/03/2022",1146,112133,1347861,500556,293172
VT,"03/10/2022",1052,113185,1352416,501669,295171
VT,"03/17/2022",848,114033,1355454,501977,296453
VT,"03/24/2022",962,114995,1358173,502244,297637
VT,"03/31/2022",955,115950,1360538,502896,298754
VT,"04/07/2022",1017,116967,1367993,503700,300174
VT,"04/14/2022",1328,118295,1379819,504554,301846
VT,"04/21/2022",1781,120076,1390595,505253,303364
VT,"04/28/2022",1966,122042,1400490,506000,304818
VT,"05/05/2022",2414,124456,1409771,506697,306197
VT,"05/12/2022",2342,126798,1418979,507556,307576
VT,"05/19/2022",2332,129130,1427786,508229,308931
VT,"05/26/2022",1807,130937,1435669,508901,310302
VT,"06/02/2022",1469,132406,1440930,509396,311581
VT,"06/09/2022",976,133382,1449560,510184,313641
VT,"06/16/2022",787,134169,1455554,510684,315395
WA,"12/17/2020",17673,215106,10,0,""
WA,"12/24/2020",16528,231634,30295,0,""
WA,"12/31/2020",13170,244804,64077,0,""
WA,"01/07/2021",17350,262154,121354,0,""
WA,"01/14/2021",19270,281424,225238,0,""
WA,"01/21/2021",13123,294547,373423,0,""
WA,"01/28/2021",11156,305703,571135,0,""
WA,"02/04/2021",11123,316826,797358,0,""
WA,"02/11/2021",8168,324994,1040044,0,""
WA,"02/18/2021",5736,330730,1255764,0,""
WA,"02/25/2021",5847,336577,1562425,0,""
WA,"03/04/2021",5503,342080,1942877,0,""
WA,"03/11/2021",4658,346738,2381471,854645,""
WA,"03/18/2021",5311,352049,2763105,1013904,""
WA,"03/25/2021",5364,357413,3170650,1165721,""
WA,"04/01/2021",7057,364470,3659886,1403264,""
WA,"04/08/2021",7443,371913,4169906,1649313,""
WA,"04/15/2021",8616,380529,4712952,1930996,""
WA,"04/22/2021",10216,390745,5224178,2163875,""
WA,"04/29/2021",9112,399857,5747171,2409840,""
WA,"05/06/2021",9943,409800,6162034,2635610,""
WA,"05/13/2021",8178,417978,6603947,2921812,""
WA,"05/20/2021",6914,424892,7029358,3183971,""
WA,"05/27/2021",7464,432356,7446412,3425147,""
WA,"06/03/2021",5181,437537,7718703,3592191,""
WA,"06/10/2021",4246,441783,7952264,3751046,""
WA,"06/17/2021",3608,445391,8241593,3951039,""
WA,"06/24/2021",3315,448706,8408738,4060008,""
WA,"07/01/2021",2557,451263,8589053,4163605,""
WA,"07/08/2021",2570,453833,8717273,4230430,""
WA,"07/15/2021",4992,458825,8812249,4287564,""
WA,"07/22/2021",5481,464306,8888521,4333260,""
WA,"07/29/2021",7518,471824,8970907,4374191,""
WA,"08/05/2021",13480,485304,9064720,4415993,""
WA,"08/12/2021",17571,502875,9160328,4454780,""
WA,"08/19/2021",20696,523571,9270975,4497187,""
WA,"08/26/2021",22235,545806,9402895,4545916,0
WA,"09/02/2021",24463,570269,9537041,4597296,0
WA,"09/09/2021",22769,593038,9663774,4647170,0
WA,"09/16/2021",23611,616649,9820796,4717519,0
WA,"09/23/2021",21009,637658,9461298,4581342,0
WA,"09/30/2021",20411,658069,9580603,4631921,0
WA,"10/07/2021",18219,676288,9765227,4698325,0
WA,"10/14/2021",15738,692026,9918603,4744875,0
WA,"10/21/2021",15497,707523,10055713,4782471,317775
WA,"10/28/2021",14822,722345,10249518,4823928,437212
WA,"11/04/2021",13116,735461,10492041,4854721,615346
WA,"11/11/2021",12397,747858,10730660,4884699,781118
WA,"11/18/2021",12283,760141,10993344,4910855,935504
WA,"11/25/2021",8804,768945,11228003,4935124,1082782
WA,"12/02/2021",9518,778463,11468556,4972495,1228781
WA,"12/09/2021",10102,788565,11786890,5048134,1422518
WA,"12/16/2021",9402,797967,12104279,5110739,1627538
WA,"12/23/2021",15541,813508,12402796,5148234,1835864
WA,"12/30/2021",35253,848761,12580215,5171727,1957263
WA,"01/06/2022",64513,913274,12740540,5193988,2064102
WA,"01/13/2022",111205,1024479,12968497,5226744,2217581
WA,"01/20/2022",106200,1130679,13162663,5295058,2349797
WA,"01/27/2022",114926,1245605,13330274,5316790,2462826
WA,"02/03/2022",83615,1329220,13476110,5341909,2552767
WA,"02/10/2022",41376,1370596,13582982,5364543,2614684
WA,"02/17/2022",22733,1393329,13738497,5412079,2661741
WA,"02/24/2022",18601,1411930,13818660,5431648,2703739
WA,"03/03/2022",15848,1427778,13878748,5447180,2734077
WA,"03/10/2022",8083,1435861,13929146,5459733,2758811
WA,"03/17/2022",7627,1443488,13970789,5469983,2779182
WA,"03/24/2022",5759,1449247,14011159,5479182,2799100
WA,"03/31/2022",5786,1455033,14046824,5487268,2816019
WA,"04/07/2022",9857,1464890,14142412,5498135,2835896
WA,"04/14/2022",7558,1472448,14248493,5506851,2854789
WA,"04/21/2022",7837,1480285,14344141,5515797,2868421
WA,"04/28/2022",14470,1494755,14425569,5523081,2880618
WA,"05/05/2022",15156,1509911,14506202,5530005,2892899
WA,"05/12/2022",16813,1526724,14585930,5536646,2904707
WA,"05/19/2022",19774,1546498,14662848,5542966,2916398
WA,"05/26/2022",22147,1568645,14738135,5549168,2930176
WA,"06/02/2022",17569,1586214,14804332,5554825,2947147
WA,"06/09/2022",20673,1606887,14877042,5560716,2969427
WA,"06/16/2022",17802,1624689,14938650,5566022,2985944
WI,"12/17/2020",25982,478162,1002,0,""
WI,"12/24/2020",22282,500444,18068,0,""
WI,"12/31/2020",15782,516226,55441,0,""
WI,"01/07/2021",19773,535999,82170,0,""
WI,"01/14/2021",22021,558020,149955,0,""
WI,"01/21/2021",15101,573121,238758,0,""
WI,"01/28/2021",12482,585603,361917,0,""
WI,"02/04/2021",10154,595757,548912,0,""
WI,"02/11/2021",7500,603257,826275,0,""
WI,"02/18/2021",5937,609194,1040145,0,""
WI,"02/25/2021",5066,614260,1314188,0,""
WI,"03/04/2021",4828,619088,1596290,0,""
WI,"03/11/2021",4064,623152,1881901,668194,""
WI,"03/18/2021",3910,627062,2210128,802989,""
WI,"03/25/2021",4242,631304,2576727,948879,""
WI,"04/01/2021",4737,636041,2969294,1105832,""
WI,"04/08/2021",5600,641641,3367885,1302712,""
WI,"04/15/2021",6458,648099,3807818,1555733,""
WI,"04/22/2021",5571,653670,4240048,1790190,""
WI,"04/29/2021",5029,658699,4580372,2011920,""
WI,"05/06/2021",4969,663668,4830952,2183603,""
WI,"05/13/2021",3934,667602,5052032,2351070,""
WI,"05/20/2021",3187,670789,5233191,2464457,""
WI,"05/27/2021",2517,673306,5405464,2553224,""
WI,"06/03/2021",1360,674666,5501966,2606191,""
WI,"06/10/2021",1063,675729,5619756,2679839,""
WI,"06/17/2021",679,676408,5728823,2753636,""
WI,"06/24/2021",619,677027,5808243,2805172,""
WI,"07/01/2021",585,677612,5918279,2886653,""
WI,"07/08/2021",603,678215,5992102,2936385,""
WI,"07/15/2021",1163,679378,6038525,2962428,""
WI,"07/22/2021",1792,681170,6083537,2986410,""
WI,"07/29/2021",3848,685018,6144722,3007524,""
WI,"08/05/2021",7172,692190,6200069,3028426,""
WI,"08/12/2021",8919,701109,6259140,3049535,""
WI,"08/19/2021",9864,710973,6324956,3076800,""
WI,"08/26/2021",11480,722453,6408718,3115895,0
WI,"09/02/2021",13810,736263,6495993,3154598,0
WI,"09/09/2021",12836,749099,6568648,3184687,0
WI,"09/16/2021",15239,764338,6640583,3220066,0
WI,"09/23/2021",22759,787097,6711667,3255405,0
WI,"09/30/2021",20358,807455,6789307,3286121,0
WI,"10/07/2021",20825,828280,6909247,3312990,0
WI,"10/14/2021",18726,847006,7032502,3344160,0
WI,"10/21/2021",15497,862503,7141619,3365525,278800
WI,"10/28/2021",14717,877220,7273809,3384470,374327
WI,"11/04/2021",15808,893028,7455498,3407176,513504
WI,"11/11/2021",20209,913237,7653108,3423825,658479
WI,"11/18/2021",23975,937212,7894520,3440272,799208
WI,"11/25/2021",26017,963229,8080069,3452828,929416
WI,"12/02/2021",23000,986229,8261595,3477030,1051773
WI,"12/09/2021",25960,1012189,8517976,3523381,1207945
WI,"12/16/2021",31504,1043693,8767000,3563900,1363095
WI,"12/23/2021",28577,1072270,8977213,3589791,1508021
WI,"12/30/2021",31484,1103754,9114543,3607515,1600126
WI,"01/06/2022",52296,1156050,9240483,3625956,1682576
WI,"01/13/2022",96841,1252891,9387518,3648131,1777142
WI,"01/20/2022",162207,1415098,9512543,3672612,1856781
WI,"01/27/2022",70956,1486054,9608200,3690547,1914749
WI,"02/03/2022",40054,1526108,9690358,3709883,1960662
WI,"02/10/2022",22178,1548286,9756060,3728134,1993761
WI,"02/17/2022",12749,1561035,9807057,3743051,2016824
WI,"02/24/2022",7765,1568800,9846287,3754939,2035373
WI,"03/03/2022",4635,1573435,9880774,3765007,2051356
WI,"03/10/2022",3201,1576636,9909880,3772654,2065816
WI,"03/17/2022",2723,1579359,9937464,3779552,2079856
WI,"03/24/2022",2583,1581942,9958715,3784664,2090271
WI,"03/31/2022",2788,1584730,9978467,3789564,2099941
WI,"04/07/2022",3261,1587991,10026729,3795002,2109389
WI,"04/14/2022",5175,1593166,10104434,3804298,2121725
WI,"04/21/2022",5610,1598776,10174992,3809686,2130908
WI,"04/28/2022",8426,1607202,10240510,3814685,2139731
WI,"05/05/2022",10821,1618023,10302747,3819467,2148369
WI,"05/12/2022",15319,1633342,10354795,3823981,2155848
WI,"05/19/2022",16273,1649615,10407703,3828435,2163431
WI,"05/26/2022",14752,1664367,10466258,3832897,2172426
WI,"06/02/2022",12994,1677361,10509357,3836568,2180406
WI,"06/09/2022",14615,1691976,10553355,3840461,2189248
WI,"06/16/2022",11221,1703197,10591765,3843762,2197617
WV,"12/17/2020",8388,66850,10436,0,""
WV,"12/24/2020",9086,75936,29902,0,""
WV,"12/31/2020",8289,84225,52837,0,""
WV,"01/07/2021",10456,94681,93467,0,""
WV,"01/14/2021",9569,104250,120851,0,""
WV,"01/21/2021",7427,111677,167548,0,""
WV,"01/28/2021",6094,117771,224604,0,""
WV,"02/04/2021",4707,122478,276753,0,""
WV,"02/11/2021",3474,125952,340780,0,""
WV,"02/18/2021",2448,128400,403532,0,""
WV,"02/25/2021",1993,130393,485535,0,""
WV,"03/04/2021",1973,132366,553449,0,""
WV,"03/11/2021",1795,134161,626149,238717,""
WV,"03/18/2021",2167,136328,709770,268847,""
WV,"03/25/2021",2490,138818,793552,300747,""
WV,"04/01/2021",2920,141738,896388,347394,""
WV,"04/08/2021",2613,144351,974007,395951,""
WV,"04/15/2021",2816,147167,1046956,447532,""
WV,"04/22/2021",2599,149766,1108422,494705,""
WV,"04/29/2021",2534,152300,1160310,534200,""
WV,"05/06/2021",2662,154962,1197152,561952,""
WV,"05/13/2021",2251,157213,1234813,580790,""
WV,"05/20/2021",1942,159155,1268895,594018,""
WV,"05/27/2021",1628,160783,1302434,605051,""
WV,"06/03/2021",1159,161942,1321189,612308,""
WV,"06/10/2021",785,162727,1350040,628131,""
WV,"06/17/2021",574,163301,1373115,644041,""
WV,"06/24/2021",387,163688,1397783,657655,""
WV,"07/01/2021",355,164043,1420441,668104,""
WV,"07/08/2021",292,164335,1476622,692019,""
WV,"07/15/2021",424,164759,1479829,694533,""
WV,"07/22/2021",638,165397,1482772,696799,""
WV,"07/29/2021",1097,166494,1486079,698893,""
WV,"08/05/2021",1839,168333,1489669,700950,""
WV,"08/12/2021",2863,171196,1494265,703416,""
WV,"08/19/2021",4443,175639,1499941,705786,""
WV,"08/26/2021",6267,181906,1508642,708548,0
WV,"09/02/2021",9250,191156,1516591,711575,0
WV,"09/09/2021",10504,201660,1523168,714231,0
WV,"09/16/2021",13324,214984,1530713,717702,0
WV,"09/23/2021",12523,227507,1537865,721140,0
WV,"09/30/2021",10991,238498,1549965,724405,0
WV,"10/07/2021",9308,247806,1564874,727400,0
WV,"10/14/2021",7972,255778,1576199,730516,0
WV,"10/21/2021",7124,262902,1583779,732955,39932
WV,"10/28/2021",6229,269131,1588844,734879,43341
WV,"11/04/2021",5379,274510,1592582,736026,46427
WV,"11/11/2021",5184,279694,1596655,737168,49621
WV,"11/18/2021",5442,285136,1687160,743319,54072
WV,"11/25/2021",5773,290909,1689798,744003,56636
WV,"12/02/2021",5040,295949,2126798,876911,65830
WV,"12/09/2021",7225,303174,2947728,1236443,169152
WV,"12/16/2021",7071,310245,3104363,1279895,227171
WV,"12/23/2021",7294,317539,2464854,982546,353981
WV,"12/30/2021",7975,325514,2490508,986688,369484
WV,"01/06/2022",17093,342607,2517331,991161,385349
WV,"01/13/2022",24610,367217,2544074,995507,401688
WV,"01/20/2022",29126,396343,2566332,1001402,414791
WV,"01/27/2022",32673,429016,2583525,1004874,424524
WV,"02/03/2022",22894,451910,2598095,1008163,432257
WV,"02/10/2022",16470,468380,2610420,1011450,438471
WV,"02/17/2022",10774,479154,2623341,1014276,443706
WV,"02/24/2022",7088,486242,2631484,1016453,447529
WV,"03/03/2022",4810,491052,2639151,1018500,451173
WV,"03/10/2022",2979,494031,2645509,1020458,454136
WV,"03/17/2022",1876,495907,2650912,1022106,456406
WV,"03/24/2022",1073,496980,2654779,1023102,458346
WV,"03/31/2022",690,497670,2660404,1024540,460843
WV,"04/07/2022",549,498219,2675592,1026528,463580
WV,"04/14/2022",437,498656,2692437,1028392,466233
WV,"04/21/2022",788,499444,2707091,1029847,468729
WV,"04/28/2022",1252,500696,2719377,1031147,470869
WV,"05/05/2022",1496,502192,2728835,1032242,472575
WV,"05/12/2022",2318,504510,2741317,1033756,474834
WV,"05/19/2022",3172,507682,2752145,1034998,476744
WV,"05/26/2022",4890,512572,2762992,1036324,478815
WV,"06/02/2022",3982,516554,2771094,1037294,480433
WV,"06/09/2022",4342,520896,2778417,1038502,482012
WV,"06/16/2022",3535,524431,2786266,1039546,483626
WY,"12/17/2020",2517,40246,336,0,""
WY,"12/24/2020",2170,42416,2108,0,""
WY,"12/31/2020",1473,43889,4763,0,""
WY,"01/07/2021",1807,45696,9324,0,""
WY,"01/14/2021",2296,47992,22745,0,""
WY,"01/21/2021",1635,49627,29309,0,""
WY,"01/28/2021",1254,50881,43425,0,""
WY,"02/04/2021",950,51831,60775,0,""
WY,"02/11/2021",738,52569,79515,0,""
WY,"02/18/2021",624,53193,105426,0,""
WY,"02/25/2021",702,53895,141545,0,""
WY,"03/04/2021",469,54364,163194,0,""
WY,"03/11/2021",436,54800,190570,71215,""
WY,"03/18/2021",410,55210,214050,81924,""
WY,"03/25/2021",458,55668,242919,95709,""
WY,"04/01/2021",442,56110,270226,108971,""
WY,"04/08/2021",442,56552,288814,120094,""
WY,"04/15/2021",433,56985,317222,135799,""
WY,"04/22/2021",398,57383,337560,148035,""
WY,"04/29/2021",465,57848,353401,158672,""
WY,"05/06/2021",446,58294,363390,165555,""
WY,"05/13/2021",494,58788,374754,173312,""
WY,"05/20/2021",510,59298,384358,178309,""
WY,"05/27/2021",448,59746,390938,181712,""
WY,"06/03/2021",487,60233,397654,185170,""
WY,"06/10/2021",475,60708,404301,188762,""
WY,"06/17/2021",429,61137,410284,192582,""
WY,"06/24/2021",411,61548,415449,195677,""
WY,"07/01/2021",522,62070,423238,199743,""
WY,"07/08/2021",481,62551,433296,205774,""
WY,"07/15/2021",562,63113,437278,207857,""
WY,"07/22/2021",669,63782,440898,209600,""
WY,"07/29/2021",775,64557,445810,211609,""
WY,"08/05/2021",1191,65748,447885,212533,""
WY,"08/12/2021",1725,67473,456497,215625,""
WY,"08/19/2021",2267,69740,464054,218300,""
WY,"08/26/2021",2827,72567,472163,221333,0
WY,"09/02/2021",3454,76021,487373,226176,0
WY,"09/09/2021",3257,79278,495322,229509,0
WY,"09/16/2021",3803,83081,504335,233559,0
WY,"09/23/2021",3636,86717,512233,237374,0
WY,"09/30/2021",3298,90015,520777,240814,0
WY,"10/07/2021",3088,93103,532009,244243,0
WY,"10/14/2021",2971,96074,542366,247246,0
WY,"10/21/2021",3017,99091,553637,250509,21246
WY,"10/28/2021",2761,101852,565644,253414,28135
WY,"11/04/2021",2433,104285,580451,255655,38226
WY,"11/11/2021",2294,106579,598469,258554,49918
WY,"11/18/2021",1947,108526,613828,260997,58124
WY,"11/25/2021",1521,110047,623826,262417,63980
WY,"12/02/2021",1113,111160,637996,264744,72324
WY,"12/09/2021",1188,112348,654677,268472,81613
WY,"12/16/2021",811,113159,666997,271528,88423
WY,"12/23/2021",743,113902,677429,273515,94562
WY,"12/30/2021",1313,115215,684672,275046,98480
WY,"01/06/2022",3437,118652,691569,276574,101993
WY,"01/13/2022",5960,124612,699335,278260,106103
WY,"01/20/2022",8956,133568,707589,286666,111865
WY,"01/27/2022",9487,143055,713287,287854,114925
WY,"02/03/2022",6161,149216,717860,289000,117293
WY,"02/10/2022",3243,152459,721525,290248,119020
WY,"02/17/2022",1754,154213,727461,291651,120416
WY,"02/24/2022",934,155147,730002,292555,121512
WY,"03/03/2022",620,155767,732002,293275,122323
WY,"03/10/2022",356,156123,733464,293820,122970
WY,"03/17/2022",206,156329,735316,294445,123820
WY,"03/24/2022",160,156489,737386,295086,124782
WY,"03/31/2022",112,156601,739155,295522,125768
WY,"04/07/2022",120,156721,743110,296503,126581
WY,"04/14/2022",114,156835,747238,297028,127281
WY,"04/21/2022",152,156987,751102,297836,127984
WY,"04/28/2022",196,157183,754580,298297,128630
WY,"05/05/2022",243,157426,757566,298781,129204
WY,"05/12/2022",344,157770,746942,294997,127675
WY,"05/19/2022",623,158393,749648,295355,128173
WY,"05/26/2022",533,158926,752388,295694,128733
WY,"06/02/2022",741,159667,754809,296009,129205
WY,"06/09/2022",1162,160829,757330,296324,129700
WY,"06/16/2022",1124,161953,759520,296656,130171
